en-US=abacus	zh=算盘
en-US=absent	zh=缺席
en-US=abstract	zh=抽象
en-US=abundance	es-ES=abundancia
en-US=accident	es-ES=accidente
en-US=accumulate	zh=积累
en-US=activate	zh=激活
en-US=actress	es-ES=actriz
en-US=address	zh=地址
en-US=adenosine	zh=腺苷
en-US=afternoon	zh=下午
en-US=agenda	zh=议程
en-US=agriculture	es-ES=agricultura
en-US=agriculture	zh=农业
en-US=airline	zh=航空公司
en-US=airport	es-ES=aeropuerto
en-US=album	es-ES=álbum
en-US=alcohol	es-ES=alcohol
en-US=allergy	zh=过敏
en-US=alliance	zh=同盟
en-US=aluminium	es-ES=aluminio
en-US=ambassador	zh=大使
en-US=amen	es-ES=amén
en-US=analysis	es-ES=análisis
en-US=analyze	es-ES=analizar
en-US=analyze	zh=分析
en-US=anatomy	es-ES=anatomía
en-US=anniversary	es-ES=aniversario
en-US=antelope	zh=羚羊
en-US=antenna	es-ES=antena
en-US=anthem	es-ES=himno
en-US=anthropology	es-ES=antropología
en-US=anyone	zh=何人
en-US=aperture	zh=光圈
en-US=apron	zh=围裙
en-US=archbishop	es-ES=arzobispo
en-US=archer	es-ES=arquero
en-US=architecture	es-ES=arquitectura
en-US=architecture	zh=建筑学
en-US=armrest	es-ES=brazo
en-US=artery	zh=动脉
en-US=artillery	es-ES=artillería
en-US=artillery	zh=火炮
en-US=artist	es-ES=artista
en-US=asbestos	zh=石棉
en-US=asleep	es-ES=dormido
en-US=asparagus	zh=芦笋
en-US=asthma	es-ES=asma
en-US=astronomer	zh=天文学家
en-US=atom	zh=原子
en-US=atrium	zh=心房
en-US=aurora	es-ES=aurora
en-US=auteur	es-ES=autor
en-US=autonomy	es-ES=autonomía
en-US=backboard	zh=篮板
en-US=background	zh=背景
en-US=backup	zh=备份
en-US=backyard	zh=后院
en-US=bacteria	es-ES=bacterias
en-US=bacteria	zh=细菌
en-US=balcony	zh=阳台
en-US=baptist	es-ES=bautista
en-US=barbershop	zh=理发店
en-US=barley	zh=大麦
en-US=baseball	es-ES=béisbol
en-US=baseball	zh=棒球
en-US=baseline	es-ES=referencia
en-US=baseline	zh=底线
en-US=basketball	zh=篮球
en-US=bassinet	es-ES=moisés
en-US=bathroom	zh=浴室
en-US=bedstead	es-ES=cama
en-US=beef	zh=牛肉
en-US=belief	es-ES=creencia
en-US=believe	zh=相信
en-US=bellboy	es-ES=botones
en-US=bench	zh=长椅
en-US=bikini	zh=比基尼
en-US=bimbo	zh=小妞
en-US=biology	es-ES=biología
en-US=biology	zh=生物学
en-US=birdcage	es-ES=jaula
en-US=biscuit	zh=饼干
en-US=blackberry	zh=黑莓
en-US=blackboard	zh=黑板
en-US=blacksmith	zh=铁匠
en-US=blanket	zh=毯子
en-US=boffin	zh=科学家
en-US=bookmark	zh=书签
en-US=booster	zh=运载火箭
en-US=breakthrough	zh=突破
en-US=breathe	es-ES=respirar
en-US=brigade	es-ES=brigada
en-US=broth	zh=肉汤
en-US=bugle	es-ES=clarín
en-US=bulkhead	zh=隔壁
en-US=bulletin	es-ES=boletín
en-US=bullet	zh=子弹
en-US=bungalow	zh=平房
en-US=cabinet	zh=内阁
en-US=cactus	zh=仙人掌
en-US=calcium	es-ES=calcio
en-US=camel	zh=骆驼
en-US=campaign	es-ES=campaña
en-US=campus	zh=校园
en-US=canary	es-ES=canario
en-US=cancer	es-ES=cáncer
en-US=cancer	zh=癌症
en-US=candidacy	es-ES=candidatura
en-US=capacitor	zh=电容器
en-US=capitalist	es-ES=capitalista
en-US=caribou	zh=驯鹿
en-US=carpet	zh=地毯
en-US=carton	zh=纸箱
en-US=catastrophe	es-ES=catástrofe
en-US=category	es-ES=categoría
en-US=cavalryman	es-ES=soldado
en-US=cave	es-ES=cueva
en-US=celery	zh=芹菜
en-US=cellulose	zh=纤维素
en-US=census	es-ES=censo
en-US=century	zh=世纪
en-US=cerebrum	zh=大脑
en-US=ceremony	es-ES=ceremonia
en-US=certificate	es-ES=certificado
en-US=chairman	es-ES=presidente
en-US=chair	zh=椅子
en-US=chancellor	es-ES=canciller
en-US=chandelier	zh=吊灯
en-US=chaos	es-ES=caos
en-US=chart	zh=图表
en-US=chemistry	es-ES=química
en-US=choir	es-ES=coro
en-US=cholesterol	es-ES=colesterol
en-US=cholesterol	zh=胆固醇
en-US=choline	es-ES=colina
en-US=choline	zh=胆碱
en-US=chronicle	es-ES=crónica
en-US=cigarette	es-ES=cigarrillo
en-US=circus	es-ES=circo
en-US=civil	es-ES=civil
en-US=classroom	es-ES=aula
en-US=cleanup	es-ES=limpieza
en-US=clergy	es-ES=clero
en-US=climate	es-ES=clima
en-US=climate	zh=气候
en-US=cloudy	zh=多云
en-US=cocaine	es-ES=cocaína
en-US=cocktail	zh=鸡尾酒
en-US=collaborate	es-ES=colaborar
en-US=colony	es-ES=colonia
en-US=coma	es-ES=coma
en-US=comedy	es-ES=comedia
en-US=comedy	zh=喜剧
en-US=commando	zh=特种兵
en-US=commerce	es-ES=comercio
en-US=commonwealth	zh=联邦
en-US=communicate	zh=沟通
en-US=communist	es-ES=comunista
en-US=comparison	es-ES=comparación
en-US=compass	zh=指南针
en-US=compatible	es-ES=compatible
en-US=compete	es-ES=competir
en-US=compete	zh=竞争
en-US=competitor	zh=选手
en-US=concept	es-ES=concepto
en-US=concerto	es-ES=concierto
en-US=connect	es-ES=conectar
en-US=conquest	es-ES=conquista
en-US=consensus	es-ES=consenso
en-US=consensus	zh=共识
en-US=considerate	es-ES=considerado
en-US=consortium	es-ES=consorcio
en-US=conspiracy	es-ES=conspiración
en-US=constituent	es-ES=constituyente
en-US=constituent	zh=成分
en-US=consultant	zh=顾问
en-US=consumer	es-ES=consumidor
en-US=consumer	zh=消费者
en-US=contact	es-ES=contacto
en-US=contemplate	es-ES=contemplar
en-US=contents	es-ES=contenido
en-US=contents	zh=内容
en-US=continent	es-ES=continente
en-US=contingent	es-ES=contingente
en-US=contribute	es-ES=contribuir
en-US=contribute	zh=贡献
en-US=convince	es-ES=convencer
en-US=corolla	zh=花冠
en-US=corpus	es-ES=corpus
en-US=corvette	zh=护卫舰
en-US=cosmos	es-ES=cosmos
en-US=costume	es-ES=traje
en-US=countenance	zh=面容
en-US=counterpart	zh=对方
en-US=counter	zh=柜台
en-US=county	es-ES=condado
en-US=coursework	zh=课程
en-US=cowboy	zh=牛仔
en-US=crackdown	es-ES=represión
en-US=creator	es-ES=creador
en-US=crisis	es-ES=crisis
en-US=crisis	zh=危机
en-US=cruelty	es-ES=crueldad
en-US=crusade	es-ES=cruzada
en-US=culture	zh=文化
en-US=curtains	es-ES=cortinas
en-US=customs	zh=关税
en-US=cutlery	zh=餐具
en-US=cycle	es-ES=ciclo
en-US=database	zh=数据库
en-US=data	es-ES=datos
en-US=daughter	es-ES=hija
en-US=daughter	zh=女儿
en-US=debt	es-ES=deuda
en-US=defendant	zh=被告
en-US=defend	es-ES=defender
en-US=defiance	es-ES=desafío
en-US=deficit	es-ES=déficit
en-US=delete	zh=删除
en-US=democracy	es-ES=democracia
en-US=democrat	es-ES=demócrata
en-US=demonstrate	zh=论证
en-US=dependent	es-ES=dependiente
en-US=deploy	zh=部署
en-US=describe	es-ES=describir
en-US=desktop	zh=桌面
en-US=diabetes	es-ES=diabetes
en-US=diabetes	zh=糖尿病
en-US=diagnose	zh=诊断
en-US=diagnosis	zh=诊断
en-US=dialog	es-ES=diálogo
en-US=diameter	es-ES=diámetro
en-US=diameter	zh=直径
en-US=diaper	zh=尿布
en-US=diary	es-ES=diario
en-US=diary	zh=日记
en-US=dictionary	es-ES=diccionario
en-US=diesel	zh=柴油
en-US=diet	es-ES=dieta
en-US=diode	zh=二极管
en-US=diplomacy	es-ES=diplomacia
en-US=directory	es-ES=directorio
en-US=disaster	es-ES=desastre
en-US=disaster	zh=灾难
en-US=discipline	zh=纪律
en-US=discount	zh=折扣
en-US=display	zh=显示器
en-US=dispute	es-ES=disputa
en-US=distance	zh=距离
en-US=distinguish	es-ES=distinguir
en-US=district	es-ES=distrito
en-US=doctorate	zh=博士
en-US=doctrine	es-ES=doctrina
en-US=domicile	es-ES=domicilio
en-US=domino	es-ES=dominó
en-US=doorstep	es-ES=umbral
en-US=dopamine	zh=多巴胺
en-US=dove	zh=鸽子
en-US=duchess	es-ES=duquesa
en-US=dune	zh=沙丘
en-US=dynamo	zh=发电机
en-US=eagle	es-ES=águila
en-US=earthquake	zh=地震
en-US=easy	es-ES=fácil
en-US=ecology	es-ES=ecología
en-US=economist	es-ES=economista
en-US=economist	zh=经济学家
en-US=economy	es-ES=economía
en-US=economy	zh=经济
en-US=editor	zh=编辑
en-US=edit	zh=编辑
en-US=efficacy	es-ES=eficacia
en-US=eighteen	es-ES=dieciocho,18
en-US=eighty	es-ES=ochenta,80
en-US=electrician	zh=电工
en-US=electrode	zh=电极
en-US=eleven	es-ES=once,11
en-US=elite	zh=精英
en-US=embargo	es-ES=embargo
en-US=embassy	es-ES=embajada
en-US=embassy	zh=大使馆
en-US=embrace	zh=拥抱
en-US=emissary	zh=使者
en-US=emperor	es-ES=emperador
en-US=empire	es-ES=imperio
en-US=empire	zh=帝国
en-US=employer	zh=雇主
en-US=energy	es-ES=energía
en-US=engine	es-ES=motor
en-US=english	es-ES=inglés
en-US=enhance	zh=改善
en-US=enter	es-ES=entrar
en-US=entrepreneur	zh=企业家
en-US=envelope	zh=信封
en-US=epee	es-ES=espada
en-US=epinephrine	zh=肾上腺素
en-US=equator	es-ES=ecuador
en-US=equilibrium	es-ES=equilibrio
en-US=equilibrium	zh=平衡
en-US=equivalent	es-ES=equivalente
en-US=ethylene	zh=乙烯
en-US=euro	es-ES=euro
en-US=euro	zh=欧元
en-US=everybody	zh=大家
en-US=explain	es-ES=explicar
en-US=explore	es-ES=explorar
en-US=extend	zh=延长
en-US=eyelash	zh=睫毛
en-US=faculty	es-ES=facultad
en-US=fatty	zh=胖子
en-US=feminist	es-ES=feminista
en-US=fetus	es-ES=feto
en-US=fifteen	es-ES=quince,15
en-US=finger	zh=手指
en-US=firewood	es-ES=leña
en-US=firework	zh=烟火
en-US=fist	zh=拳头
en-US=flamingo	es-ES=flamenco
en-US=flashlight	zh=手电筒
en-US=flax	zh=亚麻
en-US=fleet	es-ES=flota
en-US=flexible	zh=灵活
en-US=fluid	es-ES=fluido
en-US=footbridge	zh=天桥
en-US=forbidden	es-ES=prohibido
en-US=forehead	es-ES=frente
en-US=forestry	zh=林业
en-US=fortune	es-ES=fortuna
en-US=forum	es-ES=foro
en-US=fourteen	es-ES=catorce,14
en-US=foxglove	es-ES=digital
en-US=fracture	zh=骨折
en-US=framework	es-ES=infraestructura
en-US=freedom	es-ES=libertad
en-US=freeway	zh=高速公路
en-US=frequent	zh=频繁
en-US=fuel	es-ES=combustible
en-US=fuel	zh=燃料
en-US=fulfill	zh=履行
en-US=furniture	zh=家具
en-US=fuselage	zh=机身
en-US=gallery	es-ES=galería
en-US=gallery	zh=画廊
en-US=garage	zh=车库
en-US=gasoline	zh=汽油
en-US=gather	zh=收集
en-US=gender	zh=性别
en-US=geometry	es-ES=geometría
en-US=giant	zh=巨人
en-US=ginkgo	zh=银杏
en-US=giraffe	zh=长颈鹿
en-US=glossy	zh=光泽
en-US=glove	zh=手套
en-US=goddess	es-ES=diosa
en-US=goddess	zh=女神
en-US=goldfish	zh=金鱼
en-US=golf	es-ES=golf
en-US=golf	zh=高尔夫球
en-US=gospel	es-ES=evangelio
en-US=govern	es-ES=gobernar
en-US=grandchild	es-ES=nieto
en-US=grandma	es-ES=abuela
en-US=grandmother	es-ES=abuela
en-US=grandson	es-ES=nieto
en-US=grandstand	zh=看台
en-US=granny	zh=奶奶
en-US=granule	zh=颗粒
en-US=grape	zh=葡萄
en-US=graphite	zh=石墨
en-US=greenhouse	zh=温室
en-US=grouper	es-ES=mero
en-US=growth	zh=生长
en-US=gunman	zh=枪手
en-US=gunpowder	zh=火药
en-US=gymnasium	es-ES=gimnasio
en-US=gymnasium	zh=健身房
en-US=haircut	zh=发型
en-US=hamster	zh=仓鼠
en-US=handbook	es-ES=manual
en-US=handbook	zh=手册
en-US=handkerchief	es-ES=pañuelo
en-US=handmade	zh=手工
en-US=hardwood	es-ES=madera
en-US=harem	zh=后宫
en-US=harm	zh=损害
en-US=harvest	zh=收获
en-US=headdress	es-ES=tocado
en-US=headscarf	es-ES=velo
en-US=hedgehog	zh=刺猬
en-US=heirloom	es-ES=patrimonio
en-US=helicopter	zh=直升机
en-US=hemisphere	es-ES=hemisferio
en-US=hemoglobin	zh=血红蛋白
en-US=heritage	zh=遗产
en-US=herpes	zh=疱疹
en-US=hickory	zh=山核桃
en-US=hidden	es-ES=oculto
en-US=hierarchy	es-ES=jerarquía
en-US=homage	es-ES=homenaje
en-US=homeowner	zh=屋主
en-US=horizon	es-ES=horizonte
en-US=hormone	zh=激素
en-US=horror	es-ES=horror
en-US=hostess	zh=女主人
en-US=hotline	zh=热线
en-US=hunter	es-ES=cazador
en-US=hunter	zh=猎人
en-US=hurricane	es-ES=huracán
en-US=hurricane	zh=飓风
en-US=hydrangea	es-ES=hortensia
en-US=hydrogen	es-ES=hidrógeno
en-US=hygiene	es-ES=higiene
en-US=hygiene	zh=卫生
en-US=hypothesis	es-ES=hipótesis
en-US=iceberg	zh=冰山
en-US=idea	es-ES=idea
en-US=ideology	es-ES=ideología
en-US=illiterate	zh=文盲
en-US=imaginary	es-ES=imaginario
en-US=important	es-ES=importante
en-US=incident	es-ES=incidente
en-US=income	es-ES=ingresos
en-US=incorporate	es-ES=incorporar
en-US=independent	es-ES=independiente
en-US=indicator	es-ES=indicador
en-US=indium	es-ES=indio
en-US=indoors	zh=室内
en-US=indoor	zh=室内
en-US=infant	zh=婴儿
en-US=inferno	es-ES=infierno
en-US=infinite	es-ES=infinito
en-US=infrastructure	es-ES=infraestructura
en-US=inhibit	zh=抑制
en-US=injustice	es-ES=injusticia
en-US=innovate	zh=创新
en-US=input	zh=输入
en-US=insecticide	zh=杀虫剂
en-US=insider	es-ES=iniciado
en-US=insomnia	es-ES=insomnio
en-US=insomnia	zh=失眠
en-US=install	es-ES=instalar
en-US=install	zh=安装
en-US=instinct	es-ES=instinto
en-US=institute	zh=学院
en-US=instructor	zh=教练
en-US=insufficient	es-ES=insuficiente
en-US=insulin	es-ES=insulina
en-US=insulin	zh=胰岛素
en-US=intelligent	es-ES=inteligente
en-US=interferon	zh=干扰素
en-US=intern	zh=实习生
en-US=intervene	es-ES=intervenir
en-US=introduce	zh=介绍
en-US=investigator	zh=调查者
en-US=invest	zh=投资
en-US=invisible	es-ES=invisible
en-US=irony	es-ES=ironía
en-US=itinerary	es-ES=itinerario
en-US=jail	es-ES=cárcel
en-US=jail	zh=监狱
en-US=journalist	zh=记者
en-US=juror	es-ES=jurado
en-US=juror	zh=陪审员
en-US=jury	es-ES=jurado
en-US=kangaroo	zh=袋鼠
en-US=keepsake	zh=纪念品
en-US=keyword	zh=关键词
en-US=kingdom	es-ES=reino
en-US=kitchen	zh=厨房
en-US=knockoff	es-ES=imitación
en-US=known	es-ES=conocido
en-US=laboratory	es-ES=laboratorio
en-US=labyrinth	es-ES=laberinto
en-US=landowner	zh=地主
en-US=landscape	zh=风景
en-US=laughter	es-ES=risa
en-US=lava	zh=熔岩
en-US=lecturer	es-ES=docente
en-US=lecture	zh=演讲
en-US=legacy	es-ES=legado
en-US=legacy	zh=遗产
en-US=legislature	es-ES=legislatura
en-US=legitimacy	es-ES=legitimidad
en-US=lend	es-ES=prestar
en-US=lettuce	es-ES=lechuga
en-US=liberty	es-ES=libertad
en-US=lieutenant	es-ES=teniente
en-US=ligand	zh=配体
en-US=limestone	zh=石灰岩
en-US=liqueur	es-ES=licor
en-US=literary	es-ES=literario
en-US=literature	es-ES=literatura
en-US=litre	es-ES=litro
en-US=liver	es-ES=hígado
en-US=lizard	zh=蜥蜴
en-US=lobster	zh=龙虾
en-US=locust	zh=蝗虫
en-US=lollipop	zh=棒棒糖
en-US=longitude	es-ES=longitud
en-US=lottery	es-ES=lotería
en-US=loyalty	es-ES=lealtad
en-US=luggage	es-ES=equipaje
en-US=lunar	es-ES=lunar
en-US=luncheon	es-ES=almuerzo
en-US=lung	es-ES=pulmón
en-US=machine	es-ES=máquina
en-US=macho	zh=男子汉
en-US=mafia	es-ES=mafia
en-US=magma	zh=岩浆
en-US=mainland	es-ES=continente
en-US=mainstream	zh=主流
en-US=majesty	es-ES=majestad
en-US=makeup	zh=化妆
en-US=manifesto	es-ES=manifiesto
en-US=manufacturer	es-ES=fabricante
en-US=manuscript	es-ES=manuscrito
en-US=maple	es-ES=arce
en-US=margin	es-ES=margen
en-US=marketplace	es-ES=mercado
en-US=mascot	zh=吉祥物
en-US=math	es-ES=matemática
en-US=mattress	zh=床垫
en-US=maverick	zh=特立独行
en-US=medium	zh=中型
en-US=melody	es-ES=melodía
en-US=membrane	es-ES=membrana
en-US=memoir	es-ES=memoria
en-US=menagerie	zh=动物园
en-US=merchandise	es-ES=mercancía
en-US=mercury	es-ES=mercurio
en-US=metaphor	es-ES=metáfora
en-US=methane	zh=甲烷
en-US=microphone	es-ES=micrófono
en-US=midnight	es-ES=medianoche
en-US=millennium	es-ES=milenio
en-US=millionaire	zh=百万富翁
en-US=ministry	es-ES=ministerio
en-US=miracle	es-ES=milagro
en-US=miracle	zh=奇迹
en-US=mirror	es-ES=espejo
en-US=mirror	zh=镜子
en-US=modern	es-ES=moderno
en-US=modify	es-ES=modificar
en-US=molecular	es-ES=molecular
en-US=molecule	es-ES=molécula
en-US=molecule	zh=分子
en-US=monarch	es-ES=monarca
en-US=monarchy	es-ES=monarquía
en-US=monastery	es-ES=monasterio
en-US=monetary	es-ES=monetario
en-US=monomer	zh=单体
en-US=monster	es-ES=monstruo
en-US=morphine	zh=吗啡
en-US=mosquito	zh=蚊子
en-US=motor	es-ES=motor
en-US=motorway	zh=公路
en-US=mountainside	es-ES=ladera
en-US=multimedia	es-ES=multimedia
en-US=multimedia	zh=多媒体
en-US=museum	es-ES=museo
en-US=museum	zh=博物馆
en-US=musician	es-ES=músico
en-US=myth	es-ES=mito
en-US=narrator	es-ES=narrador
en-US=nationalist	es-ES=nacionalista
en-US=nature	es-ES=naturaleza
en-US=nature	zh=自然
en-US=navy	zh=海军
en-US=nebula	zh=星云
en-US=necklace	zh=项链
en-US=necktie	es-ES=corbata
en-US=necktie	zh=领带
en-US=negotiate	zh=谈判
en-US=nephew	es-ES=sobrino
en-US=neutron	zh=中子
en-US=newsroom	zh=编辑部
en-US=nicotine	zh=尼古丁
en-US=nine	es-ES=nueve,9
en-US=ninety	es-ES=noventa,90
en-US=nitrogen	es-ES=nitrógeno
en-US=northwest	es-ES=noroeste
en-US=northwest	zh=西北
en-US=nostalgia	es-ES=nostalgia
en-US=notepad	zh=记事本
en-US=novelty	es-ES=novedad
en-US=nuclear	es-ES=nuclear
en-US=nude	es-ES=desnudo
en-US=nylon	zh=尼龙
en-US=observer	es-ES=observador
en-US=occur	zh=发生
en-US=ocean	es-ES=océano
en-US=opera	es-ES=ópera
en-US=operator	es-ES=operador
en-US=optimize	zh=优化
en-US=orchestra	es-ES=orquesta
en-US=orchid	zh=兰花
en-US=organize	es-ES=organizar
en-US=organizer	es-ES=organizador
en-US=organize	zh=组织
en-US=orient	es-ES=orientar
en-US=ostrich	zh=鸵鸟
en-US=outcry	es-ES=protesta
en-US=outer	es-ES=externo
en-US=outfield	es-ES=jardín
en-US=outline	zh=轮廓
en-US=output	zh=输出
en-US=overpass	zh=立交桥
en-US=overuse	es-ES=usar
en-US=owner	zh=所有者
en-US=oxidase	zh=氧化酶
en-US=oxygen	es-ES=oxígeno
en-US=ozone	zh=臭氧
en-US=panorama	es-ES=panorama
en-US=papaya	zh=木瓜
en-US=parade	zh=游行
en-US=paradigm	es-ES=paradigma
en-US=paradise	es-ES=paraíso
en-US=paradox	es-ES=paradoja
en-US=paragraph	es-ES=párrafo
en-US=parallel	es-ES=paralelo
en-US=parent	es-ES=padre
en-US=parents	es-ES=padres
en-US=parliamentary	es-ES=parlamentario
en-US=parsley	es-ES=perejil
en-US=particular	es-ES=particular
en-US=passport	es-ES=pasaporte
en-US=passport	zh=护照
en-US=patent	zh=专利
en-US=pathology	es-ES=patología
en-US=patient	es-ES=paciente
en-US=patriot	zh=爱国者
en-US=peaceful	zh=平安
en-US=peasant	es-ES=campesino
en-US=penalty	zh=惩罚
en-US=pencil	es-ES=lápiz
en-US=pencil	zh=铅笔
en-US=penguin	zh=企鹅
en-US=peninsula	es-ES=península
en-US=peony	zh=牡丹
en-US=percentage	es-ES=porcentaje
en-US=permanent	es-ES=permanente
en-US=persistent	es-ES=persistente
en-US=persona	es-ES=personaje
en-US=phenomenon	zh=现象
en-US=phosphatase	zh=磷酸酶
en-US=phosphate	zh=磷酸盐
en-US=photographer	zh=摄影师
en-US=photon	zh=光子
en-US=physicist	es-ES=físico
en-US=pigeon	zh=鸽子
en-US=pillow	es-ES=almohada
en-US=pint	es-ES=pinta
en-US=pipeline	zh=管道
en-US=piston	zh=活塞
en-US=pixel	zh=像素
en-US=placebo	zh=安慰剂
en-US=plaintiff	zh=原告
en-US=planet	es-ES=planeta
en-US=planet	zh=行星
en-US=planner	es-ES=agenda
en-US=plasma	es-ES=plasma
en-US=plaster	zh=石膏
en-US=playmate	zh=玩伴
en-US=plaza	zh=广场
en-US=poet	zh=诗人
en-US=polyester	zh=聚酯
en-US=polyethylene	zh=聚乙烯
en-US=polymerase	zh=聚合酶
en-US=polypeptide	zh=多肽
en-US=polypropylene	zh=聚丙烯
en-US=polyurethane	zh=聚氨酯
en-US=poplar	zh=杨树
en-US=poppy	zh=罂粟
en-US=popular	es-ES=popular
en-US=pork	zh=猪肉
en-US=portrait	es-ES=retrato
en-US=portrait	zh=肖像
en-US=possible	es-ES=posible
en-US=postdoc	zh=博士后
en-US=powerful	es-ES=poderoso
en-US=practice	zh=练习
en-US=practise	es-ES=practicar
en-US=prairie	zh=草原
en-US=precinct	es-ES=recinto
en-US=precursor	zh=先驱
en-US=prepare	zh=准备
en-US=prisoner	zh=囚犯
en-US=privacy	zh=隐私
en-US=process	zh=过程
en-US=proclaim	zh=宣布
en-US=producer	es-ES=productor
en-US=product	es-ES=producto
en-US=progress	es-ES=progreso
en-US=proof	zh=证据
en-US=propaganda	es-ES=propaganda
en-US=protagonist	es-ES=protagonista
en-US=protease	zh=蛋白酶
en-US=protein	es-ES=proteína
en-US=proton	zh=质子
en-US=proud	es-ES=orgulloso
en-US=provide	zh=供给
en-US=province	es-ES=provincia
en-US=prudent	es-ES=prudente
en-US=psychiatry	es-ES=psiquiatría
en-US=psychology	es-ES=psicología
en-US=publish	zh=出版
en-US=puck	zh=冰球
en-US=pulmonary	es-ES=pulmonar
en-US=pulse	es-ES=pulso
en-US=pumpkin	zh=南瓜
en-US=puppy	zh=小狗
en-US=purchase	zh=购买
en-US=pyramid	es-ES=pirámide
en-US=quadrant	zh=象限
en-US=quest	es-ES=búsqueda
en-US=questionnaire	zh=问卷
en-US=radar	zh=雷达
en-US=rainfall	es-ES=precipitación
en-US=raisin	es-ES=pasa
en-US=ranch	es-ES=rancho
en-US=random	zh=随机
en-US=ravine	zh=山沟
en-US=rebuild	es-ES=reconstruir
en-US=recent	es-ES=reciente
en-US=recipe	es-ES=receta
en-US=recommend	zh=推荐
en-US=reconnaissance	es-ES=reconocimiento
en-US=reflex	es-ES=reflejo
en-US=reform	zh=改革
en-US=refrigerator	zh=冰箱
en-US=regime	es-ES=régimen
en-US=regulate	zh=调节
en-US=relish	zh=品味
en-US=remedy	zh=医药
en-US=remind	zh=提醒
en-US=renaissance	zh=复兴
en-US=repair	zh=修理
en-US=repeat	zh=重复
en-US=repertoire	es-ES=repertorio
en-US=reporter	zh=记者
en-US=represent	es-ES=representar
en-US=researcher	es-ES=investigador
en-US=reservoir	zh=水库
en-US=resident	zh=居民
en-US=resist	es-ES=resistir
en-US=resource	zh=资源
en-US=respond	es-ES=responder
en-US=response	zh=回答
en-US=revenue	zh=收入
en-US=reverse	zh=倒车
en-US=revolver	es-ES=revólver
en-US=rhubarb	zh=大黄
en-US=rhythm	es-ES=ritmo
en-US=rhythm	zh=节奏
en-US=robbery	zh=抢劫
en-US=rocket	zh=火箭
en-US=rogue	zh=狐狸精
en-US=romance	es-ES=romance
en-US=rosary	es-ES=rosario
en-US=rosemary	es-ES=romero
en-US=routine	zh=常规
en-US=sailboat	zh=帆船
en-US=salad	es-ES=ensalada
en-US=salmonella	zh=沙门氏菌
en-US=sandstone	zh=砂岩
en-US=satellite	es-ES=satélite
en-US=scan	zh=扫描
en-US=scientist	zh=科学家
en-US=screenwriter	zh=编剧
en-US=seashore	zh=海岸
en-US=seawater	zh=海水
en-US=semester	es-ES=semestre
en-US=semester	zh=学期
en-US=seminar	es-ES=seminario
en-US=settee	es-ES=sofá
en-US=seven	es-ES=siete,7
en-US=seventeen	es-ES=diecisiete,17
en-US=seventy	es-ES=setenta,70
en-US=sexy	zh=性感
en-US=shadow	es-ES=sombra
en-US=shareholder	zh=股东
en-US=shark	zh=鲨鱼
en-US=sheepskin	zh=羊皮
en-US=shelf	zh=架子
en-US=shellfish	zh=贝类
en-US=shire	es-ES=condado
en-US=shirt	es-ES=camisa
en-US=shopkeeper	zh=店主
en-US=shortfall	es-ES=déficit
en-US=shunt	zh=分流
en-US=signature	es-ES=firma
en-US=silk	es-ES=seda
en-US=silverware	es-ES=cubiertos
en-US=sincere	es-ES=sincero
en-US=singer	zh=歌手
en-US=sixteen	es-ES=dieciséis,16
en-US=sixth	es-ES=sexto
en-US=sixty	es-ES=sesenta,60
en-US=slavery	es-ES=esclavitud
en-US=slave	zh=奴隶
en-US=sleeve	zh=袖子
en-US=slipper	zh=拖鞋
en-US=smear	zh=涂抹
en-US=snowman	zh=雪人
en-US=socialist	es-ES=socialista
en-US=sociology	es-ES=sociología
en-US=sofa	es-ES=sofá
en-US=sofa	zh=沙发
en-US=softball	zh=垒球
en-US=softy	es-ES=sentimental
en-US=song	es-ES=canción
en-US=soprano	zh=女高音
en-US=sorghum	zh=高粱
en-US=southwest	zh=西南
en-US=sovereignty	es-ES=soberanía
en-US=specialist	es-ES=especialista
en-US=specialty	es-ES=especialidad
en-US=species	es-ES=especie
en-US=spectator	es-ES=espectador
en-US=spider	es-ES=araña
en-US=spider	zh=蜘蛛
en-US=spinach	zh=菠菜
en-US=spokesman	zh=发言人
en-US=spokesperson	zh=发言人
en-US=sportswear	zh=运动服
en-US=springboard	zh=跳板
en-US=springtime	es-ES=primavera
en-US=stadium	zh=体育场
en-US=standard	zh=标准
en-US=statue	es-ES=estatua
en-US=stimulus	es-ES=estímulo
en-US=stoneware	zh=石器
en-US=storm	zh=风暴
en-US=strategy	es-ES=estrategia
en-US=strategy	zh=战略
en-US=strawberry	zh=草莓
en-US=strength	zh=力气
en-US=stress	zh=压力
en-US=strict	es-ES=estricto
en-US=strict	zh=严格
en-US=structure	zh=结构
en-US=studio	es-ES=estudio
en-US=sublime	zh=崇高
en-US=subscribe	zh=订阅
en-US=subsequent	zh=随后
en-US=success	zh=成功
en-US=sucrose	zh=蔗糖
en-US=sufficient	es-ES=suficiente
en-US=summary	zh=摘要
en-US=sunshine	zh=阳光
en-US=superior	es-ES=superior
en-US=superior	zh=优越
en-US=suppress	zh=抑制
en-US=supreme	es-ES=supremo
en-US=surgeon	zh=外科医生
en-US=surname	es-ES=apellido
en-US=surplus	zh=过剩
en-US=surroundings	es-ES=entorno
en-US=survivor	zh=幸存者
en-US=suture	zh=缝合
en-US=swim	zh=游泳
en-US=swine	zh=卑贱
en-US=symphony	es-ES=sinfonía
en-US=symptom	es-ES=síntoma
en-US=symptom	zh=症状
en-US=syndrome	es-ES=síndrome
en-US=system	es-ES=sistema
en-US=tariff	zh=关税
en-US=teach	es-ES=enseñar
en-US=teapot	zh=茶壶
en-US=teaspoon	zh=茶匙
en-US=technician	es-ES=técnico
en-US=technique	es-ES=técnica
en-US=technology	es-ES=tecnología
en-US=telescope	es-ES=telescopio
en-US=temperature	zh=温度
en-US=temporary	zh=暂时
en-US=tennis	es-ES=tenis
en-US=tennis	zh=网球
en-US=tent	zh=帐篷
en-US=territory	es-ES=territorio
en-US=terror	es-ES=terror
en-US=terrorist	es-ES=terrorista
en-US=testimony	es-ES=testimonio
en-US=thank	es-ES=agradecer
en-US=theft	zh=盗窃
en-US=theology	es-ES=teología
en-US=therapy	es-ES=terapia
en-US=therapy	zh=疗法
en-US=thigh	zh=大腿
en-US=thirteen	es-ES=trece,13
en-US=thirty	es-ES=treinta,30
en-US=threat	es-ES=amenaza
en-US=three	es-ES=tres,3
en-US=throughout	zh=到处
en-US=thwart	zh=阻挠
en-US=tidy	zh=整齐
en-US=tobacco	es-ES=tabaco
en-US=tolerance	es-ES=tolerancia
en-US=tolerance	zh=宽容
en-US=tomato	es-ES=tomate
en-US=tomb	es-ES=tumba
en-US=tomorrow	es-ES=mañana
en-US=toolbox	zh=工具箱
en-US=toothbrush	zh=牙刷
en-US=toothpaste	zh=牙膏
en-US=torso	zh=躯干
en-US=tourist	es-ES=turista
en-US=townsman	zh=市民
en-US=trace	zh=痕迹
en-US=tragedy	es-ES=tragedia
en-US=trailblazer	zh=先驱
en-US=trajectory	es-ES=trayectoria
en-US=trance	es-ES=trance
en-US=transit	zh=通过
en-US=transplant	zh=移植
en-US=treaty	zh=条约
en-US=trek	es-ES=jornada
en-US=triangle	es-ES=triángulo
en-US=tribe	es-ES=tribu
en-US=tribune	es-ES=tribuna
en-US=tripod	zh=三脚架
en-US=truth	es-ES=verdad
en-US=tsunami	zh=海啸
en-US=tuberculosis	es-ES=tuberculosis
en-US=tulip	zh=郁金香
en-US=tuna	zh=金枪鱼
en-US=turkey	zh=火鸡
en-US=twelve	es-ES=doce,12
en-US=twenty	es-ES=veinte,20
en-US=underpants	zh=内裤
en-US=unfair	zh=不公平
en-US=uniform	es-ES=uniforme
en-US=unit	es-ES=unidad
en-US=unite	zh=结合
en-US=universe	es-ES=universo
en-US=universe	zh=宇宙
en-US=update	zh=更新
en-US=upgrade	zh=升级
en-US=upstairs	zh=楼上
en-US=upstream	zh=上游
en-US=urban	es-ES=urbano
en-US=urine	es-ES=orina
en-US=user	es-ES=usuario
en-US=utopia	es-ES=utopía
en-US=vaccine	es-ES=vacuna
en-US=vaccine	zh=疫苗
en-US=vampire	zh=吸血鬼
en-US=vanguard	es-ES=vanguardia
en-US=vase	zh=花瓶
en-US=vent	zh=发泄
en-US=verb	es-ES=verbo
en-US=veterinarian	zh=兽医
en-US=victory	es-ES=victoria
en-US=vinegar	es-ES=vinagre
en-US=vintage	zh=年份
en-US=violin	es-ES=violín
en-US=virtue	es-ES=virtud
en-US=virus	es-ES=virus
en-US=visa	zh=签证
en-US=visible	es-ES=visible
en-US=visitor	es-ES=visita
en-US=void	zh=空洞
en-US=volcano	es-ES=volcán
en-US=volleyball	zh=排球
en-US=voltage	zh=电压
en-US=volume	es-ES=volumen
en-US=voluntary	es-ES=voluntario
en-US=volunteer	es-ES=voluntario
en-US=waif	es-ES=hallazgo
en-US=walnut	zh=核桃
en-US=warfare	es-ES=guerra
en-US=warfare	zh=战争
en-US=warm	zh=暖和
en-US=waterfall	zh=瀑布
en-US=watermelon	zh=西瓜
en-US=wealth	zh=财富
en-US=weapon	es-ES=arma
en-US=weaponry	es-ES=armas
en-US=website	zh=网站
en-US=wetland	zh=湿地
en-US=whatsoever	zh=任何
en-US=wheat	es-ES=trigo
en-US=wheelchair	zh=轮椅
en-US=width	zh=宽度
en-US=wildlife	zh=野生动物
en-US=windfall	zh=暴利
en-US=windmill	zh=风车
en-US=window	es-ES=ventana
en-US=wisdom	es-ES=sabiduría
en-US=wisdom	zh=智慧
en-US=woman	es-ES=mujer
en-US=wonderland	zh=仙境
en-US=wool	zh=羊毛
en-US=workbench	zh=工作台
en-US=workout	zh=锻炼
en-US=worldwide	zh=全球
en-US=wristwatch	zh=手表
en-US=yesterday	es-ES=ayer
es-ES=abdomen	en-US=abdomen
es-ES=aburrimiento	en-US=boredom
es-ES=academia	en-US=academy
es-ES=académica	en-US=academician
es-ES=actualización	en-US=update
es-ES=ademán	en-US=gesture
es-ES=adoptada	en-US=adoptee
es-ES=adoptar	en-US=adopt
es-ES=adulta	en-US=adult
es-ES=adversario	en-US=adversary
es-ES=aeropuerto	en-US=airport
es-ES=agrario	en-US=agrarian
es-ES=alrededores	en-US=outskirts
es-ES=aluminio	en-US=aluminium,aluminum
es-ES=amarillo	en-US=yellow
es-ES=amén	en-US=amen
es-ES=amnistía	en-US=amnesty
es-ES=anatomía	en-US=anatomy
es-ES=anécdota	en-US=anecdote
es-ES=aniversario	en-US=anniversary
es-ES=antiterrorista	en-US=antiterrorist
es-ES=antología	en-US=anthology
es-ES=antropología	en-US=anthropology
es-ES=aprender	en-US=learn
es-ES=araña	en-US=spider
es-ES=arce	en-US=maple
es-ES=archipiélago	en-US=archipelago
es-ES=arquitecto	en-US=architect
es-ES=arquitectura	en-US=architecture
es-ES=arzobispo	en-US=archbishop
es-ES=asma	en-US=asthma
es-ES=atardecer	en-US=sunset
es-ES=atleta	en-US=athlete
es-ES=auge	en-US=heyday
es-ES=aula	en-US=classroom
es-ES=bacterias	en-US=bacteria
es-ES=baja	en-US=casualty
es-ES=ballet	en-US=ballet
es-ES=baloncesto	en-US=basketball
es-ES=banquero	en-US=banker
es-ES=béisbol	en-US=baseball
es-ES=bicicleta	en-US=bicycle
es-ES=biología	en-US=biology
es-ES=boletín	en-US=bulletin
es-ES=botones	en-US=bellboy
es-ES=brigada	en-US=brigade
es-ES=burgués	en-US=bourgeois
es-ES=burguesía	en-US=bourgeoisie
es-ES=calcio	en-US=calcium
es-ES=cáncer	en-US=cancer
es-ES=canciller	en-US=chancellor
es-ES=canción	en-US=song
es-ES=candidato	en-US=candidate
es-ES=canela	en-US=cinnamon
es-ES=caos	en-US=chaos
es-ES=captura	en-US=capture
es-ES=carolina	en-US=cockatiel
es-ES=cartón	en-US=cardboard
es-ES=cascos	en-US=headphones
es-ES=catálogo	en-US=catalogue,catalog
es-ES=catástrofe	en-US=catastrophe
es-ES=catorce	en-US=fourteen,14
es-ES=cazador	en-US=hunter
es-ES=celos	en-US=jealousy
es-ES=censo	en-US=census
es-ES=cerebro	en-US=brain
es-ES=certificado	en-US=certificate
es-ES=cheque	en-US=cheque,check
es-ES=ciclista	en-US=cyclist
es-ES=cierta	en-US=certain
es-ES=cineasta	en-US=filmmaker
es-ES=cirujano	en-US=surgeon
es-ES=ciudadana	en-US=citizen
es-ES=civil	en-US=civil
es-ES=clarín	en-US=bugle
es-ES=claustro	en-US=cloister
es-ES=clero	en-US=clergy
es-ES=cocaína	en-US=cocaine
es-ES=colaborar	en-US=collaborate
es-ES=colesterol	en-US=cholesterol
es-ES=comedia	en-US=comedy
es-ES=comisario	en-US=curator
es-ES=comparación	en-US=comparison
es-ES=compatible	en-US=compatible
es-ES=compatriota	en-US=compatriot
es-ES=compositor	en-US=composer
es-ES=compra	en-US=purchase
es-ES=comprensible	en-US=comprehensible
es-ES=compuesto	en-US=compound
es-ES=concepto	en-US=concept
es-ES=concertación	en-US=concert
es-ES=conectar	en-US=connect
es-ES=confiado	en-US=confident
es-ES=conflicto	en-US=conflict
es-ES=conocimientos	en-US=knowledge
es-ES=conquista	en-US=conquest
es-ES=conquistar	en-US=conquer
es-ES=conseguido	en-US=successful
es-ES=consenso	en-US=consensus
es-ES=considerado	en-US=considerate
es-ES=constituyente	en-US=constituent
es-ES=consumidor	en-US=consumer
es-ES=contacto	en-US=contact
es-ES=contribuir	en-US=contribute
es-ES=controversia	en-US=controversy
es-ES=convencer	en-US=convince
es-ES=convivir	en-US=cohabit
es-ES=coordinar	en-US=coordinate
es-ES=corbata	en-US=necktie
es-ES=corpus	en-US=corpus
es-ES=cosmos	en-US=cosmos
es-ES=crear	en-US=create
es-ES=cumpleaños	en-US=birthday
es-ES=deberes	en-US=homework
es-ES=década	en-US=decade
es-ES=decenas	en-US=dozen
es-ES=decidir	en-US=decide
es-ES=décima	en-US=tenth
es-ES=décimo	en-US=tenth
es-ES=decorado	en-US=scenery
es-ES=dedicar	en-US=devote
es-ES=democracia	en-US=democracy
es-ES=demócrata	en-US=democrat
es-ES=deportivas	en-US=sneaker
es-ES=desayuno	en-US=breakfast
es-ES=despido	en-US=layoff
es-ES=deuda	en-US=debt
es-ES=diabetes	en-US=diabetes
es-ES=diámetro	en-US=diameter
es-ES=diccionario	en-US=dictionary
es-ES=dictador	en-US=dictator
es-ES=diecinueve	en-US=nineteen,19
es-ES=dieciocho	en-US=eighteen,18
es-ES=dieciséis	en-US=sixteen,16
es-ES=diecisiete	en-US=seventeen,17
es-ES=dieta	en-US=diet
es-ES=diferenciar	en-US=differentiate
es-ES=diplomacia	en-US=diplomacy
es-ES=diplomática	en-US=diplomat
es-ES=discípulo	en-US=disciple
es-ES=distinción	en-US=renown
es-ES=distrito	en-US=district
es-ES=divorcio	en-US=divorce
es-ES=doce	en-US=twelve,12
es-ES=docena	en-US=dozen
es-ES=doctrina	en-US=doctrine
es-ES=documental	en-US=documentary
es-ES=drama	en-US=drama
es-ES=dueña	en-US=chaperone
es-ES=duquesa	en-US=duchess
es-ES=ecología	en-US=ecology
es-ES=economista	en-US=economist
es-ES=ecuador	en-US=equator
es-ES=electorado	en-US=electorate
es-ES=embajada	en-US=embassy
es-ES=embajador	en-US=ambassador
es-ES=enamorada	en-US=lover
es-ES=encabezado	en-US=header
es-ES=enemigo	en-US=enemy
es-ES=ensalada	en-US=salad
es-ES=enseña	en-US=ensign
es-ES=entrevista	en-US=interview
es-ES=envergadura	en-US=wingspan
es-ES=equipaje	en-US=luggage
es-ES=escuchar	en-US=listen
es-ES=escultor	en-US=sculptor
es-ES=espanto	en-US=dismay
es-ES=especialidad	en-US=specialty
es-ES=especie	en-US=species
es-ES=espejo	en-US=mirror
es-ES=espionaje	en-US=espionage
es-ES=estatua	en-US=statue
es-ES=estímulo	en-US=stimulus
es-ES=euro	en-US=euro
es-ES=evangelio	en-US=gospel
es-ES=exactitud	en-US=accuracy
es-ES=explorar	en-US=explore
es-ES=éxtasis	en-US=ecstasy
es-ES=fabricante	en-US=manufacturer
es-ES=falange	en-US=phalanx
es-ES=farmacia	en-US=pharmacy
es-ES=feminista	en-US=feminist
es-ES=feto	en-US=fetus,foetus
es-ES=filósofo	en-US=philosopher
es-ES=foro	en-US=forum
es-ES=fotógrafo	en-US=photographer
es-ES=frecuente	en-US=frequent
es-ES=gasolina	en-US=gasoline
es-ES=gastar	en-US=spend
es-ES=geometría	en-US=geometry
es-ES=gobernador	en-US=governor
es-ES=golf	en-US=golf
es-ES=hegemonía	en-US=hegemony
es-ES=hembra	en-US=female
es-ES=hidrógeno	en-US=hydrogen
es-ES=hígado	en-US=liver
es-ES=higiene	en-US=hygiene
es-ES=historiador	en-US=historian
es-ES=honestidad	en-US=honesty
es-ES=horizonte	en-US=horizon
es-ES=horror	en-US=horror
es-ES=hortensia	en-US=hydrangea
es-ES=hotel	en-US=hotel
es-ES=huracán	en-US=hurricane
es-ES=identificar	en-US=identify
es-ES=ideología	en-US=ideology
es-ES=iglesia	en-US=church
es-ES=imaginado	en-US=fanciful
es-ES=imaginario	en-US=imaginary
es-ES=impacto	en-US=impact
es-ES=imperio	en-US=empire
es-ES=incesante	en-US=incessant
es-ES=incorporado	en-US=corporate
es-ES=indicaciones	en-US=directions
es-ES=inexistente	en-US=nonexistent
es-ES=infancia	en-US=childhood
es-ES=infantería	en-US=infantry
es-ES=ingeniero	en-US=engineer
es-ES=injusticia	en-US=injustice
es-ES=insistir	en-US=insist
es-ES=insomnio	en-US=insomnia
es-ES=instinto	en-US=instinct
es-ES=instituto	en-US=institute
es-ES=instrucciones	en-US=directions
es-ES=insuficiente	en-US=insufficient
es-ES=insulina	en-US=insulin
es-ES=intolerancia	en-US=intolerance
es-ES=inventario	en-US=inventory
es-ES=invisible	en-US=invisible
es-ES=ironía	en-US=irony
es-ES=irreversible	en-US=irreversible
es-ES=jerarquía	en-US=hierarchy
es-ES=joyas	en-US=jewellery,jewelry
es-ES=kilo	en-US=kilo
es-ES=kilómetro	en-US=kilometre,kilometer
es-ES=laboratorio	en-US=laboratory
es-ES=ladera	en-US=mountainside
es-ES=lago	en-US=lake
es-ES=lápiz	en-US=pencil
es-ES=lechuga	en-US=lettuce
es-ES=legado	en-US=legacy
es-ES=legislador	en-US=legislator
es-ES=legislatura	en-US=legislature
es-ES=legitimidad	en-US=legitimacy
es-ES=literatura	en-US=literature
es-ES=litro	en-US=litre,liter
es-ES=locutor	en-US=announcer
es-ES=lujo	en-US=luxury
es-ES=mafia	en-US=mafia
es-ES=magistrado	en-US=magistrate
es-ES=magnífico	en-US=magnificent
es-ES=magnitud	en-US=magnitude
es-ES=maniobra	en-US=maneuver,manoeuvre
es-ES=mantequilla	en-US=butter
es-ES=manuscrito	en-US=manuscript
es-ES=maquillaje	en-US=makeup
es-ES=maquinaria	en-US=machinery
es-ES=máquinas	en-US=machinery
es-ES=marina	en-US=navy
es-ES=marino	en-US=marine
es-ES=maternidad	en-US=motherhood
es-ES=medianoche	en-US=midnight
es-ES=medicina	en-US=medicine
es-ES=membrana	en-US=membrane
es-ES=mensaje	en-US=message
es-ES=menú	en-US=menu
es-ES=mercantil	en-US=mercantile
es-ES=metáfora	en-US=metaphor
es-ES=meterse	en-US=intrude
es-ES=método	en-US=method
es-ES=milenio	en-US=millennium
es-ES=ministerio	en-US=ministry
es-ES=misterio	en-US=mystery
es-ES=mito	en-US=myth
es-ES=moisés	en-US=bassinet
es-ES=molécula	en-US=molecule
es-ES=molecular	en-US=molecular
es-ES=monarca	en-US=monarch
es-ES=monarquía	en-US=monarchy
es-ES=monasterio	en-US=monastery
es-ES=montaña	en-US=mountain
es-ES=muertos	en-US=dead
es-ES=multimedia	en-US=multimedia
es-ES=muscular	en-US=muscular
es-ES=museo	en-US=museum
es-ES=músico	en-US=musician
es-ES=muslo	en-US=thigh
es-ES=nacionalista	en-US=nationalist
es-ES=niños	en-US=childish
es-ES=nitrógeno	en-US=nitrogen
es-ES=nómina	en-US=payroll
es-ES=noroeste	en-US=northwest
es-ES=novelista	en-US=novelist
es-ES=noventa	en-US=ninety,90
es-ES=nuclear	en-US=nuclear
es-ES=nueve	en-US=nine,9
es-ES=obispo	en-US=bishop
es-ES=obrera	en-US=worker
es-ES=océano	en-US=ocean
es-ES=ochenta	en-US=eighty,80
es-ES=octavo	en-US=eighth
es-ES=olvidar	en-US=forget
es-ES=operador	en-US=operator
es-ES=ópera	en-US=opera
es-ES=órbita	en-US=orbit
es-ES=orientar	en-US=orient
es-ES=orquesta	en-US=orchestra
es-ES=oxígeno	en-US=oxygen
es-ES=padres	en-US=parents
es-ES=pañuelo	en-US=handkerchief
es-ES=paradigma	en-US=paradigm
es-ES=paradoja	en-US=paradox
es-ES=paralelo	en-US=parallel
es-ES=párrafo	en-US=paragraph
es-ES=partidario	en-US=partisan
es-ES=pasa	en-US=raisin
es-ES=pasaporte	en-US=passport
es-ES=patología	en-US=pathology
es-ES=península	en-US=peninsula
es-ES=perejil	en-US=parsley
es-ES=perfume	en-US=perfume
es-ES=periodista	en-US=journalist
es-ES=pianista	en-US=pianist
es-ES=pintar	en-US=paint
es-ES=pirámide	en-US=pyramid
es-ES=planeta	en-US=planet
es-ES=plasma	en-US=plasma
es-ES=poeta	en-US=poet
es-ES=porcentaje	en-US=percentage
es-ES=posible	en-US=possible
es-ES=prado	en-US=meadow
es-ES=precisar	en-US=precise
es-ES=prestigio	en-US=prestige
es-ES=pretexto	en-US=pretext
es-ES=príncipe	en-US=prince
es-ES=procedencia	en-US=provenance
es-ES=procedimiento	en-US=procedure
es-ES=productor	en-US=producer
es-ES=prólogo	en-US=prologue,prolog
es-ES=propaganda	en-US=propaganda
es-ES=protagonista	en-US=protagonist
es-ES=proteína	en-US=protein
es-ES=provecho	en-US=advantage
es-ES=psicoanálisis	en-US=psychoanalysis
es-ES=psicología	en-US=psychology
es-ES=psicosis	en-US=psychosis
es-ES=psiquiatra	en-US=psychiatrist
es-ES=psiquiatría	en-US=psychiatry
es-ES=publicar	en-US=publish
es-ES=pulmonar	en-US=pulmonary
es-ES=pulmón	en-US=lung
es-ES=puré	en-US=puree
es-ES=quince	en-US=fifteen,15
es-ES=recibo	en-US=receipt
es-ES=reciente	en-US=recent
es-ES=redacción	en-US=essay
es-ES=referéndum	en-US=referendum
es-ES=reforma	en-US=reform
es-ES=refugiado	en-US=refugee
es-ES=relevante	en-US=relevant
es-ES=repertorio	en-US=repertoire
es-ES=represión	en-US=crackdown
es-ES=respirar	en-US=breathe
es-ES=restaurante	en-US=restaurant
es-ES=retirado	en-US=veteran
es-ES=revolucionaria	en-US=revolutionary
es-ES=revolucionario	en-US=revolutionary
es-ES=revólver	en-US=revolver
es-ES=romero	en-US=rosemary
es-ES=sabor	en-US=flavor,flavour
es-ES=sacerdote	en-US=priest
es-ES=saldo	en-US=remainder
es-ES=saliva	en-US=saliva
es-ES=sanidad	en-US=health
es-ES=seda	en-US=silk
es-ES=seminario	en-US=seminar
es-ES=señores	en-US=gentleman
es-ES=sequía	en-US=drought
es-ES=sesenta	en-US=sixty,60
es-ES=setenta	en-US=seventy,70
es-ES=sexto	en-US=sixth
es-ES=siete	en-US=seven,7
es-ES=siglo	en-US=century
es-ES=silueta	en-US=silhouette
es-ES=simpatía	en-US=warmth
es-ES=síndrome	en-US=syndrome
es-ES=sinfonía	en-US=symphony
es-ES=síntoma	en-US=symptom
es-ES=sistema	en-US=system
es-ES=soberanía	en-US=sovereignty
es-ES=sociedad	en-US=society
es-ES=sociología	en-US=sociology
es-ES=software	en-US=software
es-ES=solucionar	en-US=solve
es-ES=soñar	en-US=dream
es-ES=sonrisa	en-US=smile
es-ES=sospechar	en-US=suspect
es-ES=suicida	en-US=suicide
es-ES=suicidio	en-US=suicide
es-ES=sustento	en-US=livelihood
es-ES=tabaco	en-US=tobacco
es-ES=tango	en-US=tango
es-ES=tarjeta	en-US=card
es-ES=técnica	en-US=technique
es-ES=tecnología	en-US=technology
es-ES=telescopio	en-US=telescope
es-ES=temperatura	en-US=temperature
es-ES=teniente	en-US=lieutenant
es-ES=teología	en-US=theology
es-ES=teórica	en-US=theorist
es-ES=terapia	en-US=therapy
es-ES=territorio	en-US=territory
es-ES=terror	en-US=terror
es-ES=terrorista	en-US=terrorist
es-ES=tesis	en-US=thesis
es-ES=tomate	en-US=tomato
es-ES=tortura	en-US=torture
es-ES=tragedia	en-US=tragedy
es-ES=traición	en-US=treason
es-ES=trámite	en-US=procedure
es-ES=trance	en-US=trance
es-ES=trece	en-US=thirteen,13
es-ES=treinta	en-US=thirty,30
es-ES=tres	en-US=three,3
es-ES=triángulo	en-US=triangle
es-ES=tribu	en-US=tribe
es-ES=tribuna	en-US=tribune
es-ES=tributo	en-US=tribute
es-ES=trigo	en-US=wheat
es-ES=turista	en-US=tourist
es-ES=única	en-US=unique
es-ES=usuario	en-US=user
es-ES=útero	en-US=womb
es-ES=utopía	en-US=utopia
es-ES=vacuna	en-US=vaccine
es-ES=vehículo	en-US=vehicle
es-ES=vehículos	en-US=vehicle
es-ES=veinte	en-US=twenty,20
es-ES=velada	en-US=soiree
es-ES=ventana	en-US=window
es-ES=verbo	en-US=verb
es-ES=veredicto	en-US=verdict
es-ES=victoria	en-US=victory
es-ES=viola	en-US=viola
es-ES=virtud	en-US=virtue
es-ES=virus	en-US=virus
es-ES=vitamina	en-US=vitamin
es-ES=volando	en-US=airborne
es-ES=volcán	en-US=volcano
es-ES=zumo	en-US=juice
zh=一堆	en-US=crowd
zh=三分之一	en-US=third
zh=三角	en-US=triangle
zh=三角形	en-US=triangle
zh=三角洲	en-US=delta
zh=上面	en-US=above
zh=不良	en-US=harmful
zh=专业	en-US=specialty
zh=专利	en-US=patent
zh=世纪	en-US=century
zh=东家	en-US=landlord
zh=丝线	en-US=silk
zh=丝绸	en-US=silk
zh=中子	en-US=neutron
zh=中级	en-US=intermediate
zh=主教	en-US=bishop
zh=主流	en-US=mainstream
zh=书签	en-US=bookmark
zh=乳胶	en-US=latex
zh=事故	en-US=accident
zh=交换机	en-US=switchboard
zh=人家	en-US=household
zh=人才	en-US=genius
zh=人质	en-US=hostage
zh=人马	en-US=centaur
zh=仙人掌	en-US=cactus
zh=企业家	en-US=entrepreneur
zh=企鹅	en-US=penguin
zh=传媒	en-US=media
zh=伴音	en-US=audio
zh=体育场	en-US=stadium
zh=使用者	en-US=user
zh=例子	en-US=example
zh=侥幸	en-US=fluke
zh=保护区	en-US=reserve
zh=保险	en-US=insurance
zh=保险业	en-US=insurance
zh=信封	en-US=envelope
zh=候补	en-US=candidate
zh=候选人	en-US=candidate
zh=储备	en-US=backlog
zh=催化剂	en-US=catalyst
zh=像素	en-US=pixel
zh=光圈	en-US=aperture
zh=光子	en-US=photon
zh=克制	en-US=restraint
zh=免除	en-US=avoid
zh=公主	en-US=princess
zh=公式	en-US=formula
zh=兰花	en-US=orchid
zh=关键词	en-US=keyword
zh=其余	en-US=remainder
zh=兽医	en-US=veterinarian
zh=内衣	en-US=underwear
zh=内阁	en-US=cabinet
zh=军官	en-US=officer
zh=农药	en-US=pesticide
zh=冰山	en-US=iceberg
zh=决心	en-US=resolve
zh=凳子	en-US=stool
zh=分流	en-US=shunt
zh=前者	en-US=former
zh=力气	en-US=strength
zh=加大	en-US=enlarge
zh=助理	en-US=assistant
zh=劳动力	en-US=workforce
zh=化合物	en-US=compound
zh=北方	en-US=north
zh=区别	en-US=distinguish
zh=医师	en-US=physician
zh=医药	en-US=remedy
zh=半夜	en-US=midnight
zh=南方	en-US=south
zh=博物馆	en-US=museum
zh=卡车	en-US=truck
zh=危机	en-US=crisis
zh=历史学家	en-US=historian
zh=厨房	en-US=kitchen
zh=反馈	en-US=feedback
zh=发泄	en-US=vent
zh=取得	en-US=acquire
zh=口令	en-US=password
zh=口袋	en-US=pocket
zh=可卡因	en-US=cocaine
zh=叶片	en-US=blade
zh=吉他	en-US=guitar
zh=吉普	en-US=jeep
zh=吉普车	en-US=jeep
zh=吉祥物	en-US=mascot
zh=名录	en-US=directory
zh=名胜古迹	en-US=landmark
zh=后院	en-US=backyard
zh=向上	en-US=improve
zh=向日葵	en-US=sunflower
zh=向量	en-US=vector
zh=含有	en-US=contain
zh=周年	en-US=anniversary
zh=咖啡因	en-US=caffeine
zh=品味	en-US=relish
zh=品种	en-US=variety
zh=哲人	en-US=sage
zh=喉咙	en-US=throat
zh=喜剧	en-US=comedy
zh=喷泉	en-US=fountain
zh=器具	en-US=appliance
zh=回路	en-US=circuit
zh=回避	en-US=avoid
zh=地产	en-US=estate
zh=地位	en-US=status
zh=地块	en-US=massif
zh=垒球	en-US=softball
zh=基建	en-US=infrastructure
zh=墨镜	en-US=sunglasses
zh=处理器	en-US=processor
zh=外科	en-US=surgery
zh=外科医生	en-US=surgeon
zh=外边	en-US=outside
zh=外面	en-US=outside
zh=多云	en-US=cloudy
zh=多媒体	en-US=multimedia
zh=大使馆	en-US=embassy
zh=大洋	en-US=ocean
zh=大理石	en-US=marble
zh=大腿	en-US=thigh
zh=大象	en-US=elephant
zh=大麦	en-US=barley
zh=天敌	en-US=predator
zh=天赋	en-US=talent
zh=太阳镜	en-US=sunglasses
zh=头像	en-US=avatar
zh=女演员	en-US=actress
zh=女神	en-US=goddess
zh=媒介	en-US=vehicle
zh=存储	en-US=storage
zh=存货	en-US=backlog
zh=季节	en-US=season
zh=安全性	en-US=safety
zh=实验室	en-US=laboratory
zh=宣扬	en-US=advertise
zh=家具	en-US=furniture
zh=家禽	en-US=poultry
zh=容貌	en-US=looks
zh=寝室	en-US=bedroom
zh=对方	en-US=counterpart
zh=寿司	en-US=sushi
zh=尊重	en-US=respect
zh=小区	en-US=compound
zh=小卖部	en-US=buffet
zh=小麦	en-US=wheat
zh=尼龙	en-US=nylon
zh=尿布	en-US=diaper
zh=尿素	en-US=urea
zh=山羊	en-US=goat
zh=工程师	en-US=engineer
zh=工艺	en-US=technology
zh=巧克力	en-US=chocolate
zh=市井	en-US=marketplace
zh=帐篷	en-US=tent
zh=帝王	en-US=emperor
zh=常规	en-US=routine
zh=常青	en-US=evergreen
zh=平台	en-US=platform
zh=平均	en-US=average
zh=平房	en-US=bungalow
zh=平方	en-US=square
zh=年份	en-US=vintage
zh=幸存者	en-US=survivor
zh=广告牌	en-US=billboard
zh=座位	en-US=seat
zh=延长	en-US=extend
zh=建筑学	en-US=architecture
zh=开心	en-US=rejoice
zh=强劲	en-US=powerful
zh=强大	en-US=powerful
zh=录像	en-US=footage
zh=录影	en-US=video
zh=形容	en-US=describe
zh=影子	en-US=shadow
zh=微笑	en-US=smile
zh=心房	en-US=atrium
zh=心理学	en-US=psychology
zh=志愿者	en-US=volunteer
zh=忠告	en-US=advice
zh=恐怕	en-US=afraid
zh=恐龙	en-US=dinosaur
zh=情绪	en-US=mood
zh=想法	en-US=idea
zh=成员	en-US=member
zh=成效	en-US=successful
zh=房东	en-US=landlord
zh=所得	en-US=earnings
zh=手套	en-US=glove
zh=手法	en-US=technique
zh=手电筒	en-US=flashlight
zh=手镯	en-US=bracelet
zh=打印机	en-US=printer
zh=扫描	en-US=scan
zh=扶梯	en-US=ladder
zh=投机	en-US=adventure
zh=投资人	en-US=investor
zh=投资者	en-US=investor
zh=折扣	en-US=discount
zh=护士	en-US=nurse
zh=报告	en-US=report
zh=抽奖	en-US=lottery
zh=抽象	en-US=abstract
zh=拖拉机	en-US=tractor
zh=拖鞋	en-US=slipper
zh=拳头	en-US=fist
zh=指数	en-US=index
zh=按摩	en-US=massage
zh=捷径	en-US=shortcut
zh=排球	en-US=volleyball
zh=推进	en-US=advance
zh=提高	en-US=improve
zh=搭档	en-US=partner
zh=支部	en-US=chapter
zh=收藏家	en-US=collector
zh=收音机	en-US=radio
zh=放松	en-US=relax
zh=政策	en-US=policy
zh=救护车	en-US=ambulance
zh=教会	en-US=church
zh=教堂	en-US=church
zh=教室	en-US=classroom
zh=教师	en-US=teacher
zh=数据	en-US=data
zh=数据库	en-US=database
zh=文献	en-US=literature
zh=斑马	en-US=zebra
zh=新人	en-US=newcomer
zh=新闻	en-US=news
zh=方针	en-US=policy
zh=旅客	en-US=passenger
zh=日记	en-US=diary
zh=早餐	en-US=breakfast
zh=早饭	en-US=breakfast
zh=昏迷	en-US=coma
zh=智慧	en-US=wisdom
zh=曲线	en-US=curve
zh=最高	en-US=supreme
zh=月份	en-US=month
zh=月台	en-US=platform
zh=有限	en-US=finite
zh=服务器	en-US=server
zh=木瓜	en-US=papaya
zh=未来	en-US=future
zh=本土	en-US=mainland
zh=本科	en-US=undergraduate
zh=本科生	en-US=undergraduate
zh=朱古力	en-US=chocolate
zh=机身	en-US=fuselage
zh=村民	en-US=villager
zh=来电	en-US=chemistry
zh=杰作	en-US=masterpiece
zh=松鼠	en-US=squirrel
zh=林子	en-US=grove
zh=枫树	en-US=maple
zh=架子	en-US=shelf
zh=柜子	en-US=cupboard
zh=柳树	en-US=willow
zh=柴油	en-US=diesel
zh=标本	en-US=specimen
zh=栖息	en-US=perch
zh=校园	en-US=campus
zh=核桃	en-US=walnut
zh=桌面	en-US=desktop
zh=桑拿	en-US=sauna
zh=梦见	en-US=dream
zh=梦魇	en-US=incubus
zh=梯子	en-US=ladder
zh=棒球	en-US=baseball
zh=椅子	en-US=chair
zh=椰子	en-US=coconut
zh=楼上	en-US=upstairs
zh=模特	en-US=mannequin
zh=橱柜	en-US=cupboard
zh=欧元	en-US=euro
zh=欲望	en-US=desire
zh=歌手	en-US=singer
zh=正方形	en-US=square
zh=比基尼	en-US=bikini
zh=毯子	en-US=blanket
zh=民主	en-US=democracy
zh=气候	en-US=climate
zh=水库	en-US=reservoir
zh=水族馆	en-US=aquarium
zh=水泡	en-US=blister
zh=汇报	en-US=report
zh=池塘	en-US=pond
zh=汽油	en-US=gasoline
zh=活塞	en-US=piston
zh=浇水	en-US=water
zh=海军	en-US=navy
zh=海洋	en-US=ocean
zh=海豚	en-US=dolphin
zh=海边	en-US=seaside
zh=涂抹	en-US=smear
zh=消费者	en-US=consumer
zh=消除	en-US=remove
zh=液体	en-US=liquid
zh=温度	en-US=temperature
zh=温柔	en-US=tender
zh=游乐园	en-US=playground
zh=湖泊	en-US=lake
zh=湖畔	en-US=lakeside
zh=湖边	en-US=lakeside
zh=湿地	en-US=wetland
zh=火炉	en-US=stove
zh=火箭	en-US=rocket
zh=灾民	en-US=refugee
zh=烟叶	en-US=tobacco
zh=烟草	en-US=tobacco
zh=烤炉	en-US=oven
zh=焦点	en-US=focus
zh=燃料	en-US=fuel
zh=爆米花	en-US=popcorn
zh=爱国者	en-US=patriot
zh=牙医	en-US=dentist
zh=牙膏	en-US=toothpaste
zh=牛仔	en-US=cowboy
zh=牛肉	en-US=beef
zh=猎人	en-US=hunter
zh=猛兽	en-US=predator
zh=猪肉	en-US=pork
zh=猴子	en-US=monkey
zh=玉石	en-US=jade
zh=王国	en-US=kingdom
zh=王妃	en-US=princess
zh=王子	en-US=prince
zh=班车	en-US=shuttle
zh=琥珀	en-US=amber
zh=瓣膜	en-US=valve
zh=瓶颈	en-US=bottleneck
zh=生日	en-US=birthday
zh=生涯	en-US=career
zh=甲醛	en-US=formaldehyde
zh=电子琴	en-US=keyboard
zh=电工	en-US=electrician
zh=电极	en-US=electrode
zh=电梯	en-US=lift
zh=电路	en-US=circuit
zh=番茄	en-US=tomato
zh=疗法	en-US=therapy
zh=疱疹	en-US=herpes
zh=病人	en-US=inmate
zh=病毒	en-US=virus
zh=症状	en-US=symptom
zh=癌症	en-US=cancer
zh=白内障	en-US=cataract
zh=百万富翁	en-US=millionaire
zh=皮夹	en-US=wallet
zh=皮革	en-US=leather
zh=直升机	en-US=helicopter
zh=眉毛	en-US=eyebrow
zh=睫毛	en-US=eyelash
zh=矢量	en-US=vector
zh=矩阵	en-US=matrix
zh=石墨	en-US=graphite
zh=石棉	en-US=asbestos
zh=矿山	en-US=mine
zh=硬件	en-US=hardware
zh=离合器	en-US=clutch
zh=离婚	en-US=divorce
zh=私立	en-US=private
zh=科技	en-US=technology
zh=秒钟	en-US=second
zh=积压	en-US=backlog
zh=稻田	en-US=paddy
zh=稻草	en-US=straw
zh=突破	en-US=breakthrough
zh=竹子	en-US=bamboo
zh=笑容	en-US=smile
zh=等离子体	en-US=plasma
zh=筹码	en-US=chip
zh=签证	en-US=visa
zh=简易	en-US=simple
zh=管道	en-US=pipeline
zh=篮子	en-US=basket
zh=篮球	en-US=basketball
zh=类别	en-US=category
zh=粒子	en-US=particle
zh=精英	en-US=elite
zh=索引	en-US=index
zh=索赔	en-US=claim
zh=纪律	en-US=discipline
zh=纳税人	en-US=taxpayer
zh=线路	en-US=circuit
zh=经济	en-US=economy
zh=维生素	en-US=vitamin
zh=绵羊	en-US=sheep
zh=缔造	en-US=create
zh=编辑部	en-US=newsroom
zh=羊毛衫	en-US=cardigan
zh=羚羊	en-US=antelope
zh=职场	en-US=workplace
zh=聚酯	en-US=polyester
zh=肝脏	en-US=liver
zh=股东	en-US=shareholder
zh=肩膀	en-US=shoulder
zh=肺脏	en-US=lung
zh=胆固醇	en-US=cholesterol
zh=胰岛素	en-US=insulin
zh=脉搏	en-US=pulse
zh=自助餐	en-US=buffet
zh=臭氧	en-US=ozone
zh=舞蹈	en-US=dance
zh=航班	en-US=flight
zh=航空公司	en-US=airline
zh=航空器	en-US=aircraft
zh=艰难	en-US=difficult
zh=艺术家	en-US=artist
zh=芒果	en-US=mango
zh=芝麻	en-US=sesame
zh=花瓶	en-US=vase
zh=范畴	en-US=category
zh=药店	en-US=pharmacy
zh=菠菜	en-US=spinach
zh=葵花	en-US=sunflower
zh=蓝宝石	en-US=sapphire
zh=蚊子	en-US=mosquito
zh=蛋白质	en-US=protein
zh=蛋糕	en-US=cake
zh=蜘蛛	en-US=spider
zh=蟋蟀	en-US=cricket
zh=血浆	en-US=plasma
zh=血液	en-US=bloodstream
zh=行人	en-US=pedestrian
zh=行者	en-US=pedestrian
zh=袖子	en-US=sleeve
zh=被告	en-US=defendant
zh=裙子	en-US=skirt
zh=西北	en-US=northwest
zh=西南	en-US=southwest
zh=西瓜	en-US=watermelon
zh=西红柿	en-US=tomato
zh=观念	en-US=concept
zh=视频	en-US=video
zh=警惕	en-US=alert
zh=警方	en-US=police
zh=讲座	en-US=seminar
zh=论证	en-US=demonstrate
zh=设定	en-US=configure
zh=试图	en-US=attempt
zh=课堂	en-US=classroom
zh=调查者	en-US=investigator
zh=账户	en-US=account
zh=购买	en-US=purchase
zh=跳马	en-US=vault
zh=车祸	en-US=accident
zh=车辆	en-US=vehicle
zh=转子	en-US=rotor
zh=轮椅	en-US=wheelchair
zh=软件	en-US=software
zh=软体	en-US=software
zh=过程	en-US=process
zh=运载火箭	en-US=booster
zh=进步	en-US=progress
zh=避难	en-US=refuge
zh=避风港	en-US=haven
zh=郁金香	en-US=tulip
zh=部长	en-US=minister
zh=金融	en-US=finance
zh=铁路	en-US=railway
zh=铁道	en-US=railway
zh=银色	en-US=silver
zh=键盘	en-US=keyboard
zh=镜子	en-US=mirror
zh=长度	en-US=length
zh=长椅	en-US=bench
zh=门将	en-US=goalkeeper
zh=阀门	en-US=valve
zh=阴沟	en-US=sewer
zh=阶段	en-US=stage
zh=附录	en-US=appendix
zh=雇员	en-US=employee
zh=雨伞	en-US=umbrella
zh=雪茄	en-US=cigar
zh=雷达	en-US=radar
zh=霓虹	en-US=neon
zh=面包车	en-US=minibus
zh=音频	en-US=audio
zh=预报	en-US=forecast
zh=预期	en-US=expect
zh=预算	en-US=budget
zh=风暴	en-US=storm
zh=香肠	en-US=sausage
zh=香蕉	en-US=banana
zh=马戏团	en-US=circus
zh=骆驼	en-US=camel
zh=高于	en-US=above
zh=鱿鱼	en-US=squid
zh=鲨鱼	en-US=shark
zh=鸡尾酒	en-US=cocktail
zh=鸡肉	en-US=chicken
zh=黄瓜	en-US=cucumber
zh=黄色	en-US=yellow
zh=黄蜂	en-US=wasp
zh=默认	en-US=default
zh=龙虾	en-US=lobster
en-US=12	en-US=twelve,12
en-US=13	en-US=thirteen,13
en-US=14	en-US=fourteen,14
en-US=15	en-US=fifteen,15
en-US=16	en-US=sixteen,16
en-US=17	en-US=seventeen,17
en-US=18	en-US=eighteen,18
en-US=19	en-US=nineteen,19
en-US=20	en-US=twenty,20
en-US=30	en-US=thirty,30
en-US=3	en-US=three,3
en-US=60	en-US=sixty,60
en-US=70	en-US=seventy,70
en-US=7	en-US=seven,7
en-US=80	en-US=eighty,80
en-US=90	en-US=ninety,90
en-US=9	en-US=nine,9
en-US=abacus	en-US=abacus
en-US=abdomen	en-US=abdomen
en-US=above	en-US=above
en-US=absent	en-US=absent
en-US=abstract	en-US=abstract
en-US=abundance	en-US=abundance
en-US=academician	en-US=academician
en-US=academy	en-US=academy
en-US=accident	en-US=accident
en-US=account	en-US=account
en-US=accumulate	en-US=accumulate
en-US=accuracy	en-US=accuracy
en-US=acquire	en-US=acquire
en-US=activate	en-US=activate
en-US=actress	en-US=actress
en-US=address	en-US=address
en-US=adenosine	en-US=adenosine
en-US=adoptee	en-US=adoptee
en-US=adopt	en-US=adopt
en-US=adult	en-US=adult
en-US=advance	en-US=advance
en-US=advantage	en-US=advantage
en-US=adventure	en-US=adventure
en-US=adversary	en-US=adversary
en-US=advertise	en-US=advertise
en-US=advice	en-US=advice
en-US=afraid	en-US=afraid
en-US=afternoon	en-US=afternoon
en-US=agenda	en-US=agenda
en-US=agrarian	en-US=agrarian
en-US=agriculture	en-US=agriculture
en-US=airborne	en-US=airborne
en-US=aircraft	en-US=aircraft
en-US=airline	en-US=airline
en-US=airport	en-US=airport
en-US=album	en-US=album
en-US=alcohol	en-US=alcohol
en-US=alert	en-US=alert
en-US=allergy	en-US=allergy
en-US=alliance	en-US=alliance
en-US=aluminum	en-US=aluminium,aluminum
en-US=ambassador	en-US=ambassador
en-US=amber	en-US=amber
en-US=ambulance	en-US=ambulance
en-US=amen	en-US=amen
en-US=amnesty	en-US=amnesty
en-US=analysis	en-US=analysis
en-US=analyze	en-US=analyze
en-US=anatomy	en-US=anatomy
en-US=anecdote	en-US=anecdote
en-US=anniversary	en-US=anniversary
en-US=announcer	en-US=announcer
en-US=antelope	en-US=antelope
en-US=antenna	en-US=antenna
en-US=anthem	en-US=anthem
en-US=anthology	en-US=anthology
en-US=anthropology	en-US=anthropology
en-US=antiterrorist	en-US=antiterrorist
en-US=anyone	en-US=anyone
en-US=aperture	en-US=aperture
en-US=appendix	en-US=appendix
en-US=appliance	en-US=appliance
en-US=apron	en-US=apron
en-US=aquarium	en-US=aquarium
en-US=archbishop	en-US=archbishop
en-US=archer	en-US=archer
en-US=archipelago	en-US=archipelago
en-US=architect	en-US=architect
en-US=architecture	en-US=architecture
en-US=armrest	en-US=armrest
en-US=artery	en-US=artery
en-US=artillery	en-US=artillery
en-US=artist	en-US=artist
en-US=asbestos	en-US=asbestos
en-US=asleep	en-US=asleep
en-US=asparagus	en-US=asparagus
en-US=assistant	en-US=assistant
en-US=asthma	en-US=asthma
en-US=astronomer	en-US=astronomer
en-US=athlete	en-US=athlete
en-US=atom	en-US=atom
en-US=atrium	en-US=atrium
en-US=attempt	en-US=attempt
en-US=audio	en-US=audio
en-US=aurora	en-US=aurora
en-US=auteur	en-US=auteur
en-US=autonomy	en-US=autonomy
en-US=avatar	en-US=avatar
en-US=average	en-US=average
en-US=avoid	en-US=avoid
en-US=backboard	en-US=backboard
en-US=background	en-US=background
en-US=backlog	en-US=backlog
en-US=backup	en-US=backup
en-US=backyard	en-US=backyard
en-US=bacteria	en-US=bacteria
en-US=balcony	en-US=balcony
en-US=ballet	en-US=ballet
en-US=bamboo	en-US=bamboo
en-US=banana	en-US=banana
en-US=banker	en-US=banker
en-US=baptist	en-US=baptist
en-US=barbershop	en-US=barbershop
en-US=barley	en-US=barley
en-US=baseball	en-US=baseball
en-US=baseline	en-US=baseline
en-US=basketball	en-US=basketball
en-US=basket	en-US=basket
en-US=bassinet	en-US=bassinet
en-US=bathroom	en-US=bathroom
en-US=bedroom	en-US=bedroom
en-US=bedstead	en-US=bedstead
en-US=beef	en-US=beef
en-US=belief	en-US=belief
en-US=believe	en-US=believe
en-US=bellboy	en-US=bellboy
en-US=bench	en-US=bench
en-US=bicycle	en-US=bicycle
en-US=bikini	en-US=bikini
en-US=billboard	en-US=billboard
en-US=bimbo	en-US=bimbo
en-US=biology	en-US=biology
en-US=birdcage	en-US=birdcage
en-US=birthday	en-US=birthday
en-US=biscuit	en-US=biscuit
en-US=bishop	en-US=bishop
en-US=blackberry	en-US=blackberry
en-US=blackboard	en-US=blackboard
en-US=blacksmith	en-US=blacksmith
en-US=blade	en-US=blade
en-US=blanket	en-US=blanket
en-US=blister	en-US=blister
en-US=bloodstream	en-US=bloodstream
en-US=boffin	en-US=boffin
en-US=bookmark	en-US=bookmark
en-US=booster	en-US=booster
en-US=boredom	en-US=boredom
en-US=bottleneck	en-US=bottleneck
en-US=bourgeois	en-US=bourgeois
en-US=bourgeoisie	en-US=bourgeoisie
en-US=bracelet	en-US=bracelet
en-US=brain	en-US=brain
en-US=breakfast	en-US=breakfast
en-US=breakthrough	en-US=breakthrough
en-US=breathe	en-US=breathe
en-US=brigade	en-US=brigade
en-US=broth	en-US=broth
en-US=budget	en-US=budget
en-US=buffet	en-US=buffet
en-US=bugle	en-US=bugle
en-US=bulkhead	en-US=bulkhead
en-US=bullet	en-US=bullet
en-US=bulletin	en-US=bulletin
en-US=bungalow	en-US=bungalow
en-US=butter	en-US=butter
en-US=cabinet	en-US=cabinet
en-US=cactus	en-US=cactus
en-US=caffeine	en-US=caffeine
en-US=cake	en-US=cake
en-US=calcium	en-US=calcium
en-US=camel	en-US=camel
en-US=campaign	en-US=campaign
en-US=campus	en-US=campus
en-US=canary	en-US=canary
en-US=cancer	en-US=cancer
en-US=candidacy	en-US=candidacy
en-US=candidate	en-US=candidate
en-US=capacitor	en-US=capacitor
en-US=capitalist	en-US=capitalist
en-US=capture	en-US=capture
en-US=cardboard	en-US=cardboard
en-US=card	en-US=card
en-US=cardigan	en-US=cardigan
en-US=career	en-US=career
en-US=caribou	en-US=caribou
en-US=carpet	en-US=carpet
en-US=carton	en-US=carton
en-US=casualty	en-US=casualty
en-US=catalog	en-US=catalogue,catalog
en-US=catalyst	en-US=catalyst
en-US=cataract	en-US=cataract
en-US=catastrophe	en-US=catastrophe
en-US=category	en-US=category
en-US=cavalryman	en-US=cavalryman
en-US=cave	en-US=cave
en-US=celery	en-US=celery
en-US=cellulose	en-US=cellulose
en-US=census	en-US=census
en-US=centaur	en-US=centaur
en-US=century	en-US=century
en-US=cerebrum	en-US=cerebrum
en-US=ceremony	en-US=ceremony
en-US=certain	en-US=certain
en-US=certificate	en-US=certificate
en-US=chair	en-US=chair
en-US=chairman	en-US=chairman
en-US=chancellor	en-US=chancellor
en-US=chandelier	en-US=chandelier
en-US=chaos	en-US=chaos
en-US=chaperone	en-US=chaperone
en-US=chapter	en-US=chapter
en-US=chart	en-US=chart
en-US=check	en-US=cheque,check
en-US=chemistry	en-US=chemistry
en-US=cheque	en-US=cheque,check
en-US=chicken	en-US=chicken
en-US=childhood	en-US=childhood
en-US=childish	en-US=childish
en-US=chip	en-US=chip
en-US=chocolate	en-US=chocolate
en-US=choir	en-US=choir
en-US=cholesterol	en-US=cholesterol
en-US=choline	en-US=choline
en-US=chronicle	en-US=chronicle
en-US=church	en-US=church
en-US=cigar	en-US=cigar
en-US=cigarette	en-US=cigarette
en-US=cinnamon	en-US=cinnamon
en-US=circuit	en-US=circuit
en-US=circus	en-US=circus
en-US=citizen	en-US=citizen
en-US=civil	en-US=civil
en-US=claim	en-US=claim
en-US=classroom	en-US=classroom
en-US=cleanup	en-US=cleanup
en-US=clergy	en-US=clergy
en-US=climate	en-US=climate
en-US=cloister	en-US=cloister
en-US=cloudy	en-US=cloudy
en-US=clutch	en-US=clutch
en-US=cocaine	en-US=cocaine
en-US=cockatiel	en-US=cockatiel
en-US=cocktail	en-US=cocktail
en-US=coconut	en-US=coconut
en-US=cohabit	en-US=cohabit
en-US=collaborate	en-US=collaborate
en-US=collector	en-US=collector
en-US=colony	en-US=colony
en-US=coma	en-US=coma
en-US=comedy	en-US=comedy
en-US=commando	en-US=commando
en-US=commerce	en-US=commerce
en-US=commonwealth	en-US=commonwealth
en-US=communicate	en-US=communicate
en-US=communist	en-US=communist
en-US=comparison	en-US=comparison
en-US=compass	en-US=compass
en-US=compatible	en-US=compatible
en-US=compatriot	en-US=compatriot
en-US=compete	en-US=compete
en-US=competitor	en-US=competitor
en-US=composer	en-US=composer
en-US=compound	en-US=compound
en-US=comprehensible	en-US=comprehensible
en-US=concept	en-US=concept
en-US=concert	en-US=concert
en-US=concerto	en-US=concerto
en-US=confident	en-US=confident
en-US=configure	en-US=configure
en-US=conflict	en-US=conflict
en-US=connect	en-US=connect
en-US=conquer	en-US=conquer
en-US=conquest	en-US=conquest
en-US=consensus	en-US=consensus
en-US=considerate	en-US=considerate
en-US=consortium	en-US=consortium
en-US=conspiracy	en-US=conspiracy
en-US=constituent	en-US=constituent
en-US=consultant	en-US=consultant
en-US=consumer	en-US=consumer
en-US=contact	en-US=contact
en-US=contain	en-US=contain
en-US=contemplate	en-US=contemplate
en-US=contents	en-US=contents
en-US=continent	en-US=continent
en-US=contingent	en-US=contingent
en-US=contribute	en-US=contribute
en-US=controversy	en-US=controversy
en-US=convince	en-US=convince
en-US=coordinate	en-US=coordinate
en-US=corolla	en-US=corolla
en-US=corporate	en-US=corporate
en-US=corpus	en-US=corpus
en-US=corvette	en-US=corvette
en-US=cosmos	en-US=cosmos
en-US=costume	en-US=costume
en-US=countenance	en-US=countenance
en-US=counter	en-US=counter
en-US=counterpart	en-US=counterpart
en-US=county	en-US=county
en-US=coursework	en-US=coursework
en-US=cowboy	en-US=cowboy
en-US=crackdown	en-US=crackdown
en-US=create	en-US=create
en-US=creator	en-US=creator
en-US=cricket	en-US=cricket
en-US=crisis	en-US=crisis
en-US=crowd	en-US=crowd
en-US=cruelty	en-US=cruelty
en-US=crusade	en-US=crusade
en-US=cucumber	en-US=cucumber
en-US=culture	en-US=culture
en-US=cupboard	en-US=cupboard
en-US=curator	en-US=curator
en-US=curtains	en-US=curtains
en-US=curve	en-US=curve
en-US=customs	en-US=customs
en-US=cutlery	en-US=cutlery
en-US=cycle	en-US=cycle
en-US=cyclist	en-US=cyclist
en-US=dance	en-US=dance
en-US=database	en-US=database
en-US=data	en-US=data
en-US=daughter	en-US=daughter
en-US=dead	en-US=dead
en-US=debt	en-US=debt
en-US=decade	en-US=decade
en-US=decide	en-US=decide
en-US=default	en-US=default
en-US=defendant	en-US=defendant
en-US=defend	en-US=defend
en-US=defiance	en-US=defiance
en-US=deficit	en-US=deficit
en-US=delete	en-US=delete
en-US=delta	en-US=delta
en-US=democracy	en-US=democracy
en-US=democrat	en-US=democrat
en-US=demonstrate	en-US=demonstrate
en-US=dentist	en-US=dentist
en-US=dependent	en-US=dependent
en-US=deploy	en-US=deploy
en-US=describe	en-US=describe
en-US=desire	en-US=desire
en-US=desktop	en-US=desktop
en-US=devote	en-US=devote
en-US=diabetes	en-US=diabetes
en-US=diagnose	en-US=diagnose
en-US=diagnosis	en-US=diagnosis
en-US=dialog	en-US=dialog
en-US=diameter	en-US=diameter
en-US=diaper	en-US=diaper
en-US=diary	en-US=diary
en-US=dictator	en-US=dictator
en-US=dictionary	en-US=dictionary
en-US=diesel	en-US=diesel
en-US=diet	en-US=diet
en-US=differentiate	en-US=differentiate
en-US=difficult	en-US=difficult
en-US=dinosaur	en-US=dinosaur
en-US=diode	en-US=diode
en-US=diplomacy	en-US=diplomacy
en-US=diplomat	en-US=diplomat
en-US=directions	en-US=directions
en-US=directory	en-US=directory
en-US=disaster	en-US=disaster
en-US=disciple	en-US=disciple
en-US=discipline	en-US=discipline
en-US=discount	en-US=discount
en-US=dismay	en-US=dismay
en-US=display	en-US=display
en-US=dispute	en-US=dispute
en-US=distance	en-US=distance
en-US=distinguish	en-US=distinguish
en-US=district	en-US=district
en-US=divorce	en-US=divorce
en-US=doctorate	en-US=doctorate
en-US=doctrine	en-US=doctrine
en-US=documentary	en-US=documentary
en-US=dolphin	en-US=dolphin
en-US=domicile	en-US=domicile
en-US=domino	en-US=domino
en-US=doorstep	en-US=doorstep
en-US=dopamine	en-US=dopamine
en-US=dove	en-US=dove
en-US=dozen	en-US=dozen
en-US=drama	en-US=drama
en-US=dream	en-US=dream
en-US=drought	en-US=drought
en-US=duchess	en-US=duchess
en-US=dune	en-US=dune
en-US=dynamo	en-US=dynamo
en-US=eagle	en-US=eagle
en-US=earnings	en-US=earnings
en-US=earthquake	en-US=earthquake
en-US=easy	en-US=easy
en-US=ecology	en-US=ecology
en-US=economist	en-US=economist
en-US=economy	en-US=economy
en-US=ecstasy	en-US=ecstasy
en-US=edit	en-US=edit
en-US=editor	en-US=editor
en-US=efficacy	en-US=efficacy
en-US=eighteen	en-US=eighteen,18
en-US=eighth	en-US=eighth
en-US=eighty	en-US=eighty,80
en-US=electorate	en-US=electorate
en-US=electrician	en-US=electrician
en-US=electrode	en-US=electrode
en-US=elephant	en-US=elephant
en-US=eleven	en-US=eleven
en-US=elite	en-US=elite
en-US=embargo	en-US=embargo
en-US=embassy	en-US=embassy
en-US=embrace	en-US=embrace
en-US=emissary	en-US=emissary
en-US=emperor	en-US=emperor
en-US=empire	en-US=empire
en-US=employee	en-US=employee
en-US=employer	en-US=employer
en-US=enemy	en-US=enemy
en-US=energy	en-US=energy
en-US=engine	en-US=engine
en-US=engineer	en-US=engineer
en-US=english	en-US=english
en-US=enhance	en-US=enhance
en-US=enlarge	en-US=enlarge
en-US=ensign	en-US=ensign
en-US=enter	en-US=enter
en-US=entrepreneur	en-US=entrepreneur
en-US=envelope	en-US=envelope
en-US=epee	en-US=epee
en-US=epinephrine	en-US=epinephrine
en-US=equator	en-US=equator
en-US=equilibrium	en-US=equilibrium
en-US=equivalent	en-US=equivalent
en-US=espionage	en-US=espionage
en-US=essay	en-US=essay
en-US=estate	en-US=estate
en-US=ethylene	en-US=ethylene
en-US=euro	en-US=euro
en-US=evergreen	en-US=evergreen
en-US=everybody	en-US=everybody
en-US=example	en-US=example
en-US=expect	en-US=expect
en-US=explain	en-US=explain
en-US=explore	en-US=explore
en-US=extend	en-US=extend
en-US=eyebrow	en-US=eyebrow
en-US=eyelash	en-US=eyelash
en-US=faculty	en-US=faculty
en-US=fanciful	en-US=fanciful
en-US=fatty	en-US=fatty
en-US=feedback	en-US=feedback
en-US=female	en-US=female
en-US=feminist	en-US=feminist
en-US=fetus	en-US=fetus,foetus
en-US=fifteen	en-US=fifteen,15
en-US=filmmaker	en-US=filmmaker
en-US=finance	en-US=finance
en-US=finger	en-US=finger
en-US=finite	en-US=finite
en-US=firewood	en-US=firewood
en-US=firework	en-US=firework
en-US=fist	en-US=fist
en-US=flamingo	en-US=flamingo
en-US=flashlight	en-US=flashlight
en-US=flavor	en-US=flavor,flavour
en-US=flax	en-US=flax
en-US=fleet	en-US=fleet
en-US=flexible	en-US=flexible
en-US=flight	en-US=flight
en-US=fluid	en-US=fluid
en-US=fluke	en-US=fluke
en-US=focus	en-US=focus
en-US=foetus	en-US=fetus,foetus
en-US=footage	en-US=footage
en-US=footbridge	en-US=footbridge
en-US=forbidden	en-US=forbidden
en-US=forecast	en-US=forecast
en-US=forehead	en-US=forehead
en-US=forestry	en-US=forestry
en-US=forget	en-US=forget
en-US=formaldehyde	en-US=formaldehyde
en-US=former	en-US=former
en-US=formula	en-US=formula
en-US=fortune	en-US=fortune
en-US=forum	en-US=forum
en-US=fountain	en-US=fountain
en-US=fourteen	en-US=fourteen,14
en-US=foxglove	en-US=foxglove
en-US=fracture	en-US=fracture
en-US=framework	en-US=framework
en-US=freedom	en-US=freedom
en-US=freeway	en-US=freeway
en-US=frequent	en-US=frequent
en-US=fuel	en-US=fuel
en-US=fulfill	en-US=fulfill
en-US=furniture	en-US=furniture
en-US=fuselage	en-US=fuselage
en-US=future	en-US=future
en-US=gallery	en-US=gallery
en-US=garage	en-US=garage
en-US=gasoline	en-US=gasoline
en-US=gather	en-US=gather
en-US=gender	en-US=gender
en-US=genius	en-US=genius
en-US=gentleman	en-US=gentleman
en-US=geometry	en-US=geometry
en-US=gesture	en-US=gesture
en-US=giant	en-US=giant
en-US=ginkgo	en-US=ginkgo
en-US=giraffe	en-US=giraffe
en-US=glossy	en-US=glossy
en-US=glove	en-US=glove
en-US=goalkeeper	en-US=goalkeeper
en-US=goat	en-US=goat
en-US=goddess	en-US=goddess
en-US=goldfish	en-US=goldfish
en-US=golf	en-US=golf
en-US=gospel	en-US=gospel
en-US=govern	en-US=govern
en-US=governor	en-US=governor
en-US=grandchild	en-US=grandchild
en-US=grandma	en-US=grandma
en-US=grandmother	en-US=grandmother
en-US=grandson	en-US=grandson
en-US=grandstand	en-US=grandstand
en-US=granny	en-US=granny
en-US=granule	en-US=granule
en-US=grape	en-US=grape
en-US=graphite	en-US=graphite
en-US=greenhouse	en-US=greenhouse
en-US=grouper	en-US=grouper
en-US=grove	en-US=grove
en-US=growth	en-US=growth
en-US=guitar	en-US=guitar
en-US=gunman	en-US=gunman
en-US=gunpowder	en-US=gunpowder
en-US=gymnasium	en-US=gymnasium
en-US=haircut	en-US=haircut
en-US=hamster	en-US=hamster
en-US=handbook	en-US=handbook
en-US=handkerchief	en-US=handkerchief
en-US=handmade	en-US=handmade
en-US=hardware	en-US=hardware
en-US=hardwood	en-US=hardwood
en-US=harem	en-US=harem
en-US=harm	en-US=harm
en-US=harmful	en-US=harmful
en-US=harvest	en-US=harvest
en-US=haven	en-US=haven
en-US=headdress	en-US=headdress
en-US=header	en-US=header
en-US=headphones	en-US=headphones
en-US=headscarf	en-US=headscarf
en-US=health	en-US=health
en-US=hedgehog	en-US=hedgehog
en-US=hegemony	en-US=hegemony
en-US=heirloom	en-US=heirloom
en-US=helicopter	en-US=helicopter
en-US=hemisphere	en-US=hemisphere
en-US=hemoglobin	en-US=hemoglobin
en-US=heritage	en-US=heritage
en-US=herpes	en-US=herpes
en-US=heyday	en-US=heyday
en-US=hickory	en-US=hickory
en-US=hidden	en-US=hidden
en-US=hierarchy	en-US=hierarchy
en-US=historian	en-US=historian
en-US=homage	en-US=homage
en-US=homeowner	en-US=homeowner
en-US=homework	en-US=homework
en-US=honesty	en-US=honesty
en-US=horizon	en-US=horizon
en-US=hormone	en-US=hormone
en-US=horror	en-US=horror
en-US=hostage	en-US=hostage
en-US=hostess	en-US=hostess
en-US=hotel	en-US=hotel
en-US=hotline	en-US=hotline
en-US=household	en-US=household
en-US=hunter	en-US=hunter
en-US=hurricane	en-US=hurricane
en-US=hydrangea	en-US=hydrangea
en-US=hydrogen	en-US=hydrogen
en-US=hygiene	en-US=hygiene
en-US=hypothesis	en-US=hypothesis
en-US=iceberg	en-US=iceberg
en-US=idea	en-US=idea
en-US=identify	en-US=identify
en-US=ideology	en-US=ideology
en-US=illiterate	en-US=illiterate
en-US=imaginary	en-US=imaginary
en-US=impact	en-US=impact
en-US=important	en-US=important
en-US=improve	en-US=improve
en-US=incessant	en-US=incessant
en-US=incident	en-US=incident
en-US=income	en-US=income
en-US=incorporate	en-US=incorporate
en-US=incubus	en-US=incubus
en-US=independent	en-US=independent
en-US=index	en-US=index
en-US=indicator	en-US=indicator
en-US=indium	en-US=indium
en-US=indoor	en-US=indoor
en-US=indoors	en-US=indoors
en-US=infant	en-US=infant
en-US=infantry	en-US=infantry
en-US=inferno	en-US=inferno
en-US=infinite	en-US=infinite
en-US=infrastructure	en-US=infrastructure
en-US=inhibit	en-US=inhibit
en-US=injustice	en-US=injustice
en-US=inmate	en-US=inmate
en-US=innovate	en-US=innovate
en-US=input	en-US=input
en-US=insecticide	en-US=insecticide
en-US=insider	en-US=insider
en-US=insist	en-US=insist
en-US=insomnia	en-US=insomnia
en-US=install	en-US=install
en-US=instinct	en-US=instinct
en-US=institute	en-US=institute
en-US=instructor	en-US=instructor
en-US=insufficient	en-US=insufficient
en-US=insulin	en-US=insulin
en-US=insurance	en-US=insurance
en-US=intelligent	en-US=intelligent
en-US=interferon	en-US=interferon
en-US=intermediate	en-US=intermediate
en-US=intern	en-US=intern
en-US=intervene	en-US=intervene
en-US=interview	en-US=interview
en-US=intolerance	en-US=intolerance
en-US=introduce	en-US=introduce
en-US=intrude	en-US=intrude
en-US=inventory	en-US=inventory
en-US=invest	en-US=invest
en-US=investigator	en-US=investigator
en-US=investor	en-US=investor
en-US=invisible	en-US=invisible
en-US=irony	en-US=irony
en-US=irreversible	en-US=irreversible
en-US=itinerary	en-US=itinerary
en-US=jade	en-US=jade
en-US=jail	en-US=jail
en-US=jealousy	en-US=jealousy
en-US=jeep	en-US=jeep
en-US=jewelry	en-US=jewellery,jewelry
en-US=journalist	en-US=journalist
en-US=juice	en-US=juice
en-US=juror	en-US=juror
en-US=jury	en-US=jury
en-US=kangaroo	en-US=kangaroo
en-US=keepsake	en-US=keepsake
en-US=keyboard	en-US=keyboard
en-US=keyword	en-US=keyword
en-US=kilo	en-US=kilo
en-US=kilometer	en-US=kilometre,kilometer
en-US=kingdom	en-US=kingdom
en-US=kitchen	en-US=kitchen
en-US=knockoff	en-US=knockoff
en-US=knowledge	en-US=knowledge
en-US=known	en-US=known
en-US=laboratory	en-US=laboratory
en-US=labyrinth	en-US=labyrinth
en-US=ladder	en-US=ladder
en-US=lake	en-US=lake
en-US=lakeside	en-US=lakeside
en-US=landlord	en-US=landlord
en-US=landmark	en-US=landmark
en-US=landowner	en-US=landowner
en-US=landscape	en-US=landscape
en-US=latex	en-US=latex
en-US=laughter	en-US=laughter
en-US=lava	en-US=lava
en-US=layoff	en-US=layoff
en-US=learn	en-US=learn
en-US=leather	en-US=leather
en-US=lecture	en-US=lecture
en-US=lecturer	en-US=lecturer
en-US=legacy	en-US=legacy
en-US=legislator	en-US=legislator
en-US=legislature	en-US=legislature
en-US=legitimacy	en-US=legitimacy
en-US=lend	en-US=lend
en-US=length	en-US=length
en-US=lettuce	en-US=lettuce
en-US=liberty	en-US=liberty
en-US=lieutenant	en-US=lieutenant
en-US=lift	en-US=lift
en-US=ligand	en-US=ligand
en-US=limestone	en-US=limestone
en-US=liqueur	en-US=liqueur
en-US=liquid	en-US=liquid
en-US=listen	en-US=listen
en-US=literary	en-US=literary
en-US=literature	en-US=literature
en-US=liter	en-US=litre,liter
en-US=livelihood	en-US=livelihood
en-US=liver	en-US=liver
en-US=lizard	en-US=lizard
en-US=lobster	en-US=lobster
en-US=locust	en-US=locust
en-US=lollipop	en-US=lollipop
en-US=longitude	en-US=longitude
en-US=looks	en-US=looks
en-US=lottery	en-US=lottery
en-US=lover	en-US=lover
en-US=loyalty	en-US=loyalty
en-US=luggage	en-US=luggage
en-US=lunar	en-US=lunar
en-US=luncheon	en-US=luncheon
en-US=lung	en-US=lung
en-US=luxury	en-US=luxury
en-US=machine	en-US=machine
en-US=machinery	en-US=machinery
en-US=macho	en-US=macho
en-US=mafia	en-US=mafia
en-US=magistrate	en-US=magistrate
en-US=magma	en-US=magma
en-US=magnificent	en-US=magnificent
en-US=magnitude	en-US=magnitude
en-US=mainland	en-US=mainland
en-US=mainstream	en-US=mainstream
en-US=majesty	en-US=majesty
en-US=makeup	en-US=makeup
en-US=maneuver	en-US=maneuver,manoeuvre
en-US=mango	en-US=mango
en-US=manifesto	en-US=manifesto
en-US=mannequin	en-US=mannequin
en-US=manoeuvre	en-US=maneuver,manoeuvre
en-US=manufacturer	en-US=manufacturer
en-US=manuscript	en-US=manuscript
en-US=maple	en-US=maple
en-US=marble	en-US=marble
en-US=margin	en-US=margin
en-US=marine	en-US=marine
en-US=marketplace	en-US=marketplace
en-US=mascot	en-US=mascot
en-US=massage	en-US=massage
en-US=massif	en-US=massif
en-US=masterpiece	en-US=masterpiece
en-US=math	en-US=math
en-US=matrix	en-US=matrix
en-US=mattress	en-US=mattress
en-US=maverick	en-US=maverick
en-US=meadow	en-US=meadow
en-US=media	en-US=media
en-US=medicine	en-US=medicine
en-US=medium	en-US=medium
en-US=melody	en-US=melody
en-US=member	en-US=member
en-US=membrane	en-US=membrane
en-US=memoir	en-US=memoir
en-US=menagerie	en-US=menagerie
en-US=menu	en-US=menu
en-US=mercantile	en-US=mercantile
en-US=merchandise	en-US=merchandise
en-US=mercury	en-US=mercury
en-US=message	en-US=message
en-US=metaphor	en-US=metaphor
en-US=methane	en-US=methane
en-US=method	en-US=method
en-US=microphone	en-US=microphone
en-US=midnight	en-US=midnight
en-US=millennium	en-US=millennium
en-US=millionaire	en-US=millionaire
en-US=mine	en-US=mine
en-US=minibus	en-US=minibus
en-US=minister	en-US=minister
en-US=ministry	en-US=ministry
en-US=miracle	en-US=miracle
en-US=mirror	en-US=mirror
en-US=modern	en-US=modern
en-US=modify	en-US=modify
en-US=molecular	en-US=molecular
en-US=molecule	en-US=molecule
en-US=monarch	en-US=monarch
en-US=monarchy	en-US=monarchy
en-US=monastery	en-US=monastery
en-US=monetary	en-US=monetary
en-US=monkey	en-US=monkey
en-US=monomer	en-US=monomer
en-US=monster	en-US=monster
en-US=month	en-US=month
en-US=mood	en-US=mood
en-US=morphine	en-US=morphine
en-US=mosquito	en-US=mosquito
en-US=motherhood	en-US=motherhood
en-US=motor	en-US=motor
en-US=motorway	en-US=motorway
en-US=mountain	en-US=mountain
en-US=mountainside	en-US=mountainside
en-US=multimedia	en-US=multimedia
en-US=muscular	en-US=muscular
en-US=museum	en-US=museum
en-US=musician	en-US=musician
en-US=mystery	en-US=mystery
en-US=myth	en-US=myth
en-US=narrator	en-US=narrator
en-US=nationalist	en-US=nationalist
en-US=nature	en-US=nature
en-US=navy	en-US=navy
en-US=nebula	en-US=nebula
en-US=necklace	en-US=necklace
en-US=necktie	en-US=necktie
en-US=negotiate	en-US=negotiate
en-US=neon	en-US=neon
en-US=nephew	en-US=nephew
en-US=neutron	en-US=neutron
en-US=newcomer	en-US=newcomer
en-US=news	en-US=news
en-US=newsroom	en-US=newsroom
en-US=nicotine	en-US=nicotine
en-US=nine	en-US=nine,9
en-US=nineteen	en-US=nineteen,19
en-US=ninety	en-US=ninety,90
en-US=nitrogen	en-US=nitrogen
en-US=nonexistent	en-US=nonexistent
en-US=north	en-US=north
en-US=northwest	en-US=northwest
en-US=nostalgia	en-US=nostalgia
en-US=notepad	en-US=notepad
en-US=novelist	en-US=novelist
en-US=novelty	en-US=novelty
en-US=nuclear	en-US=nuclear
en-US=nude	en-US=nude
en-US=nurse	en-US=nurse
en-US=nylon	en-US=nylon
en-US=observer	en-US=observer
en-US=occur	en-US=occur
en-US=ocean	en-US=ocean
en-US=officer	en-US=officer
en-US=opera	en-US=opera
en-US=operator	en-US=operator
en-US=optimize	en-US=optimize
en-US=orbit	en-US=orbit
en-US=orchestra	en-US=orchestra
en-US=orchid	en-US=orchid
en-US=organize	en-US=organize
en-US=organizer	en-US=organizer
en-US=orient	en-US=orient
en-US=ostrich	en-US=ostrich
en-US=outcry	en-US=outcry
en-US=outer	en-US=outer
en-US=outfield	en-US=outfield
en-US=outline	en-US=outline
en-US=output	en-US=output
en-US=outside	en-US=outside
en-US=outskirts	en-US=outskirts
en-US=oven	en-US=oven
en-US=overpass	en-US=overpass
en-US=overuse	en-US=overuse
en-US=owner	en-US=owner
en-US=oxidase	en-US=oxidase
en-US=oxygen	en-US=oxygen
en-US=ozone	en-US=ozone
en-US=paddy	en-US=paddy
en-US=paint	en-US=paint
en-US=panorama	en-US=panorama
en-US=papaya	en-US=papaya
en-US=parade	en-US=parade
en-US=paradigm	en-US=paradigm
en-US=paradise	en-US=paradise
en-US=paradox	en-US=paradox
en-US=paragraph	en-US=paragraph
en-US=parallel	en-US=parallel
en-US=parent	en-US=parent
en-US=parents	en-US=parents
en-US=parliamentary	en-US=parliamentary
en-US=parsley	en-US=parsley
en-US=particle	en-US=particle
en-US=particular	en-US=particular
en-US=partisan	en-US=partisan
en-US=partner	en-US=partner
en-US=passenger	en-US=passenger
en-US=passport	en-US=passport
en-US=password	en-US=password
en-US=patent	en-US=patent
en-US=pathology	en-US=pathology
en-US=patient	en-US=patient
en-US=patriot	en-US=patriot
en-US=payroll	en-US=payroll
en-US=peaceful	en-US=peaceful
en-US=peasant	en-US=peasant
en-US=pedestrian	en-US=pedestrian
en-US=penalty	en-US=penalty
en-US=pencil	en-US=pencil
en-US=penguin	en-US=penguin
en-US=peninsula	en-US=peninsula
en-US=peony	en-US=peony
en-US=percentage	en-US=percentage
en-US=perch	en-US=perch
en-US=perfume	en-US=perfume
en-US=permanent	en-US=permanent
en-US=persistent	en-US=persistent
en-US=persona	en-US=persona
en-US=pesticide	en-US=pesticide
en-US=phalanx	en-US=phalanx
en-US=pharmacy	en-US=pharmacy
en-US=phenomenon	en-US=phenomenon
en-US=philosopher	en-US=philosopher
en-US=phosphatase	en-US=phosphatase
en-US=phosphate	en-US=phosphate
en-US=photographer	en-US=photographer
en-US=photon	en-US=photon
en-US=physician	en-US=physician
en-US=physicist	en-US=physicist
en-US=pianist	en-US=pianist
en-US=pigeon	en-US=pigeon
en-US=pillow	en-US=pillow
en-US=pint	en-US=pint
en-US=pipeline	en-US=pipeline
en-US=piston	en-US=piston
en-US=pixel	en-US=pixel
en-US=placebo	en-US=placebo
en-US=plaintiff	en-US=plaintiff
en-US=planet	en-US=planet
en-US=planner	en-US=planner
en-US=plasma	en-US=plasma
en-US=plaster	en-US=plaster
en-US=platform	en-US=platform
en-US=playground	en-US=playground
en-US=playmate	en-US=playmate
en-US=plaza	en-US=plaza
en-US=pocket	en-US=pocket
en-US=poet	en-US=poet
en-US=police	en-US=police
en-US=policy	en-US=policy
en-US=polyester	en-US=polyester
en-US=polyethylene	en-US=polyethylene
en-US=polymerase	en-US=polymerase
en-US=polypeptide	en-US=polypeptide
en-US=polypropylene	en-US=polypropylene
en-US=polyurethane	en-US=polyurethane
en-US=pond	en-US=pond
en-US=popcorn	en-US=popcorn
en-US=poplar	en-US=poplar
en-US=poppy	en-US=poppy
en-US=popular	en-US=popular
en-US=pork	en-US=pork
en-US=portrait	en-US=portrait
en-US=possible	en-US=possible
en-US=postdoc	en-US=postdoc
en-US=poultry	en-US=poultry
en-US=powerful	en-US=powerful
en-US=practice	en-US=practice
en-US=practise	en-US=practise
en-US=prairie	en-US=prairie
en-US=precinct	en-US=precinct
en-US=precise	en-US=precise
en-US=precursor	en-US=precursor
en-US=predator	en-US=predator
en-US=prepare	en-US=prepare
en-US=prestige	en-US=prestige
en-US=pretext	en-US=pretext
en-US=priest	en-US=priest
en-US=prince	en-US=prince
en-US=princess	en-US=princess
en-US=printer	en-US=printer
en-US=prisoner	en-US=prisoner
en-US=privacy	en-US=privacy
en-US=private	en-US=private
en-US=procedure	en-US=procedure
en-US=process	en-US=process
en-US=processor	en-US=processor
en-US=proclaim	en-US=proclaim
en-US=producer	en-US=producer
en-US=product	en-US=product
en-US=progress	en-US=progress
en-US=prologue	en-US=prologue,prolog
en-US=proof	en-US=proof
en-US=propaganda	en-US=propaganda
en-US=protagonist	en-US=protagonist
en-US=protease	en-US=protease
en-US=protein	en-US=protein
en-US=proton	en-US=proton
en-US=proud	en-US=proud
en-US=provenance	en-US=provenance
en-US=provide	en-US=provide
en-US=province	en-US=province
en-US=prudent	en-US=prudent
en-US=psychiatrist	en-US=psychiatrist
en-US=psychiatry	en-US=psychiatry
en-US=psychoanalysis	en-US=psychoanalysis
en-US=psychology	en-US=psychology
en-US=psychosis	en-US=psychosis
en-US=publish	en-US=publish
en-US=puck	en-US=puck
en-US=pulmonary	en-US=pulmonary
en-US=pulse	en-US=pulse
en-US=pumpkin	en-US=pumpkin
en-US=puppy	en-US=puppy
en-US=purchase	en-US=purchase
en-US=puree	en-US=puree
en-US=pyramid	en-US=pyramid
en-US=quadrant	en-US=quadrant
en-US=quest	en-US=quest
en-US=questionnaire	en-US=questionnaire
en-US=radar	en-US=radar
en-US=radio	en-US=radio
en-US=railway	en-US=railway
en-US=rainfall	en-US=rainfall
en-US=raisin	en-US=raisin
en-US=ranch	en-US=ranch
en-US=random	en-US=random
en-US=ravine	en-US=ravine
en-US=rebuild	en-US=rebuild
en-US=receipt	en-US=receipt
en-US=recent	en-US=recent
en-US=recipe	en-US=recipe
en-US=recommend	en-US=recommend
en-US=reconnaissance	en-US=reconnaissance
en-US=referendum	en-US=referendum
en-US=reflex	en-US=reflex
en-US=reform	en-US=reform
en-US=refrigerator	en-US=refrigerator
en-US=refugee	en-US=refugee
en-US=refuge	en-US=refuge
en-US=regime	en-US=regime
en-US=regulate	en-US=regulate
en-US=rejoice	en-US=rejoice
en-US=relax	en-US=relax
en-US=relevant	en-US=relevant
en-US=relish	en-US=relish
en-US=remainder	en-US=remainder
en-US=remedy	en-US=remedy
en-US=remind	en-US=remind
en-US=remove	en-US=remove
en-US=renaissance	en-US=renaissance
en-US=renown	en-US=renown
en-US=repair	en-US=repair
en-US=repeat	en-US=repeat
en-US=repertoire	en-US=repertoire
en-US=report	en-US=report
en-US=reporter	en-US=reporter
en-US=represent	en-US=represent
en-US=researcher	en-US=researcher
en-US=reserve	en-US=reserve
en-US=reservoir	en-US=reservoir
en-US=resident	en-US=resident
en-US=resist	en-US=resist
en-US=resolve	en-US=resolve
en-US=resource	en-US=resource
en-US=respect	en-US=respect
en-US=respond	en-US=respond
en-US=response	en-US=response
en-US=restaurant	en-US=restaurant
en-US=restraint	en-US=restraint
en-US=revenue	en-US=revenue
en-US=reverse	en-US=reverse
en-US=revolutionary	en-US=revolutionary
en-US=revolver	en-US=revolver
en-US=rhubarb	en-US=rhubarb
en-US=rhythm	en-US=rhythm
en-US=robbery	en-US=robbery
en-US=rocket	en-US=rocket
en-US=rogue	en-US=rogue
en-US=romance	en-US=romance
en-US=rosary	en-US=rosary
en-US=rosemary	en-US=rosemary
en-US=rotor	en-US=rotor
en-US=routine	en-US=routine
en-US=safety	en-US=safety
en-US=sage	en-US=sage
en-US=sailboat	en-US=sailboat
en-US=salad	en-US=salad
en-US=saliva	en-US=saliva
en-US=salmonella	en-US=salmonella
en-US=sandstone	en-US=sandstone
en-US=sapphire	en-US=sapphire
en-US=satellite	en-US=satellite
en-US=sauna	en-US=sauna
en-US=sausage	en-US=sausage
en-US=scan	en-US=scan
en-US=scenery	en-US=scenery
en-US=scientist	en-US=scientist
en-US=screenwriter	en-US=screenwriter
en-US=sculptor	en-US=sculptor
en-US=seashore	en-US=seashore
en-US=seaside	en-US=seaside
en-US=season	en-US=season
en-US=seat	en-US=seat
en-US=seawater	en-US=seawater
en-US=second	en-US=second
en-US=semester	en-US=semester
en-US=seminar	en-US=seminar
en-US=server	en-US=server
en-US=sesame	en-US=sesame
en-US=settee	en-US=settee
en-US=seven	en-US=seven,7
en-US=seventeen	en-US=seventeen,17
en-US=seventy	en-US=seventy,70
en-US=sewer	en-US=sewer
en-US=sexy	en-US=sexy
en-US=shadow	en-US=shadow
en-US=shareholder	en-US=shareholder
en-US=shark	en-US=shark
en-US=sheep	en-US=sheep
en-US=sheepskin	en-US=sheepskin
en-US=shelf	en-US=shelf
en-US=shellfish	en-US=shellfish
en-US=shire	en-US=shire
en-US=shirt	en-US=shirt
en-US=shopkeeper	en-US=shopkeeper
en-US=shortcut	en-US=shortcut
en-US=shortfall	en-US=shortfall
en-US=shoulder	en-US=shoulder
en-US=shunt	en-US=shunt
en-US=shuttle	en-US=shuttle
en-US=signature	en-US=signature
en-US=silhouette	en-US=silhouette
en-US=silk	en-US=silk
en-US=silver	en-US=silver
en-US=silverware	en-US=silverware
en-US=simple	en-US=simple
en-US=sincere	en-US=sincere
en-US=singer	en-US=singer
en-US=sixteen	en-US=sixteen,16
en-US=sixth	en-US=sixth
en-US=sixty	en-US=sixty,60
en-US=skirt	en-US=skirt
en-US=slave	en-US=slave
en-US=slavery	en-US=slavery
en-US=sleeve	en-US=sleeve
en-US=slipper	en-US=slipper
en-US=smear	en-US=smear
en-US=smile	en-US=smile
en-US=sneaker	en-US=sneaker
en-US=snowman	en-US=snowman
en-US=socialist	en-US=socialist
en-US=society	en-US=society
en-US=sociology	en-US=sociology
en-US=sofa	en-US=sofa
en-US=softball	en-US=softball
en-US=software	en-US=software
en-US=softy	en-US=softy
en-US=soiree	en-US=soiree
en-US=solve	en-US=solve
en-US=song	en-US=song
en-US=soprano	en-US=soprano
en-US=sorghum	en-US=sorghum
en-US=south	en-US=south
en-US=southwest	en-US=southwest
en-US=sovereignty	en-US=sovereignty
en-US=specialist	en-US=specialist
en-US=specialty	en-US=specialty
en-US=species	en-US=species
en-US=specimen	en-US=specimen
en-US=spectator	en-US=spectator
en-US=spend	en-US=spend
en-US=spider	en-US=spider
en-US=spinach	en-US=spinach
en-US=spokesman	en-US=spokesman
en-US=spokesperson	en-US=spokesperson
en-US=sportswear	en-US=sportswear
en-US=springboard	en-US=springboard
en-US=springtime	en-US=springtime
en-US=square	en-US=square
en-US=squid	en-US=squid
en-US=squirrel	en-US=squirrel
en-US=stadium	en-US=stadium
en-US=stage	en-US=stage
en-US=standard	en-US=standard
en-US=statue	en-US=statue
en-US=status	en-US=status
en-US=stimulus	en-US=stimulus
en-US=stoneware	en-US=stoneware
en-US=stool	en-US=stool
en-US=storage	en-US=storage
en-US=storm	en-US=storm
en-US=stove	en-US=stove
en-US=strategy	en-US=strategy
en-US=strawberry	en-US=strawberry
en-US=straw	en-US=straw
en-US=strength	en-US=strength
en-US=stress	en-US=stress
en-US=strict	en-US=strict
en-US=structure	en-US=structure
en-US=studio	en-US=studio
en-US=sublime	en-US=sublime
en-US=subscribe	en-US=subscribe
en-US=subsequent	en-US=subsequent
en-US=success	en-US=success
en-US=successful	en-US=successful
en-US=sucrose	en-US=sucrose
en-US=sufficient	en-US=sufficient
en-US=suicide	en-US=suicide
en-US=summary	en-US=summary
en-US=sunflower	en-US=sunflower
en-US=sunglasses	en-US=sunglasses
en-US=sunset	en-US=sunset
en-US=sunshine	en-US=sunshine
en-US=superior	en-US=superior
en-US=suppress	en-US=suppress
en-US=supreme	en-US=supreme
en-US=surgeon	en-US=surgeon
en-US=surgery	en-US=surgery
en-US=surname	en-US=surname
en-US=surplus	en-US=surplus
en-US=surroundings	en-US=surroundings
en-US=survivor	en-US=survivor
en-US=sushi	en-US=sushi
en-US=suspect	en-US=suspect
en-US=suture	en-US=suture
en-US=swim	en-US=swim
en-US=swine	en-US=swine
en-US=switchboard	en-US=switchboard
en-US=symphony	en-US=symphony
en-US=symptom	en-US=symptom
en-US=syndrome	en-US=syndrome
en-US=system	en-US=system
en-US=talent	en-US=talent
en-US=tango	en-US=tango
en-US=tariff	en-US=tariff
en-US=taxpayer	en-US=taxpayer
en-US=teach	en-US=teach
en-US=teacher	en-US=teacher
en-US=teapot	en-US=teapot
en-US=teaspoon	en-US=teaspoon
en-US=technician	en-US=technician
en-US=technique	en-US=technique
en-US=technology	en-US=technology
en-US=telescope	en-US=telescope
en-US=temperature	en-US=temperature
en-US=temporary	en-US=temporary
en-US=tender	en-US=tender
en-US=tennis	en-US=tennis
en-US=tent	en-US=tent
en-US=tenth	en-US=tenth
en-US=territory	en-US=territory
en-US=terror	en-US=terror
en-US=terrorist	en-US=terrorist
en-US=testimony	en-US=testimony
en-US=thank	en-US=thank
en-US=theft	en-US=theft
en-US=theology	en-US=theology
en-US=theorist	en-US=theorist
en-US=therapy	en-US=therapy
en-US=thesis	en-US=thesis
en-US=thigh	en-US=thigh
en-US=third	en-US=third
en-US=thirteen	en-US=thirteen,13
en-US=thirty	en-US=thirty,30
en-US=threat	en-US=threat
en-US=three	en-US=three,3
en-US=throat	en-US=throat
en-US=throughout	en-US=throughout
en-US=thwart	en-US=thwart
en-US=tidy	en-US=tidy
en-US=tobacco	en-US=tobacco
en-US=tolerance	en-US=tolerance
en-US=tomato	en-US=tomato
en-US=tomb	en-US=tomb
en-US=tomorrow	en-US=tomorrow
en-US=toolbox	en-US=toolbox
en-US=toothbrush	en-US=toothbrush
en-US=toothpaste	en-US=toothpaste
en-US=torso	en-US=torso
en-US=torture	en-US=torture
en-US=tourist	en-US=tourist
en-US=townsman	en-US=townsman
en-US=trace	en-US=trace
en-US=tractor	en-US=tractor
en-US=tragedy	en-US=tragedy
en-US=trailblazer	en-US=trailblazer
en-US=trajectory	en-US=trajectory
en-US=trance	en-US=trance
en-US=transit	en-US=transit
en-US=transplant	en-US=transplant
en-US=treason	en-US=treason
en-US=treaty	en-US=treaty
en-US=trek	en-US=trek
en-US=triangle	en-US=triangle
en-US=tribe	en-US=tribe
en-US=tribune	en-US=tribune
en-US=tribute	en-US=tribute
en-US=tripod	en-US=tripod
en-US=truck	en-US=truck
en-US=truth	en-US=truth
en-US=tsunami	en-US=tsunami
en-US=tuberculosis	en-US=tuberculosis
en-US=tulip	en-US=tulip
en-US=tuna	en-US=tuna
en-US=turkey	en-US=turkey
en-US=twelve	en-US=twelve,12
en-US=twenty	en-US=twenty,20
en-US=umbrella	en-US=umbrella
en-US=undergraduate	en-US=undergraduate
en-US=underpants	en-US=underpants
en-US=underwear	en-US=underwear
en-US=unfair	en-US=unfair
en-US=uniform	en-US=uniform
en-US=unique	en-US=unique
en-US=unite	en-US=unite
en-US=unit	en-US=unit
en-US=universe	en-US=universe
en-US=update	en-US=update
en-US=upgrade	en-US=upgrade
en-US=upstairs	en-US=upstairs
en-US=upstream	en-US=upstream
en-US=urban	en-US=urban
en-US=urea	en-US=urea
en-US=urine	en-US=urine
en-US=user	en-US=user
en-US=utopia	en-US=utopia
en-US=vaccine	en-US=vaccine
en-US=valve	en-US=valve
en-US=vampire	en-US=vampire
en-US=vanguard	en-US=vanguard
en-US=variety	en-US=variety
en-US=vase	en-US=vase
en-US=vault	en-US=vault
en-US=vector	en-US=vector
en-US=vehicle	en-US=vehicle
en-US=vent	en-US=vent
en-US=verb	en-US=verb
en-US=verdict	en-US=verdict
en-US=veteran	en-US=veteran
en-US=veterinarian	en-US=veterinarian
en-US=victory	en-US=victory
en-US=video	en-US=video
en-US=villager	en-US=villager
en-US=vinegar	en-US=vinegar
en-US=vintage	en-US=vintage
en-US=viola	en-US=viola
en-US=violin	en-US=violin
en-US=virtue	en-US=virtue
en-US=virus	en-US=virus
en-US=visa	en-US=visa
en-US=visible	en-US=visible
en-US=visitor	en-US=visitor
en-US=vitamin	en-US=vitamin
en-US=void	en-US=void
en-US=volcano	en-US=volcano
en-US=volleyball	en-US=volleyball
en-US=voltage	en-US=voltage
en-US=volume	en-US=volume
en-US=voluntary	en-US=voluntary
en-US=volunteer	en-US=volunteer
en-US=waif	en-US=waif
en-US=wallet	en-US=wallet
en-US=walnut	en-US=walnut
en-US=warfare	en-US=warfare
en-US=warm	en-US=warm
en-US=warmth	en-US=warmth
en-US=wasp	en-US=wasp
en-US=water	en-US=water
en-US=waterfall	en-US=waterfall
en-US=watermelon	en-US=watermelon
en-US=wealth	en-US=wealth
en-US=weapon	en-US=weapon
en-US=weaponry	en-US=weaponry
en-US=website	en-US=website
en-US=wetland	en-US=wetland
en-US=whatsoever	en-US=whatsoever
en-US=wheat	en-US=wheat
en-US=wheelchair	en-US=wheelchair
en-US=width	en-US=width
en-US=wildlife	en-US=wildlife
en-US=willow	en-US=willow
en-US=windfall	en-US=windfall
en-US=windmill	en-US=windmill
en-US=window	en-US=window
en-US=wingspan	en-US=wingspan
en-US=wisdom	en-US=wisdom
en-US=woman	en-US=woman
en-US=womb	en-US=womb
en-US=wonderland	en-US=wonderland
en-US=wool	en-US=wool
en-US=workbench	en-US=workbench
en-US=worker	en-US=worker
en-US=workforce	en-US=workforce
en-US=workout	en-US=workout
en-US=workplace	en-US=workplace
en-US=worldwide	en-US=worldwide
en-US=wristwatch	en-US=wristwatch
en-US=yellow	en-US=yellow
en-US=yesterday	en-US=yesterday
en-US=zebra	en-US=zebra
